id,release_date,movie,production_budget,domestic_gross,worldwide_gross,profit,primary_title,start_year,genres
7,2018,Avengers: Infinity War,300000000,"$678,815,482",2048134200,1748134200,Avengers: Infinity War,2018,Action/Adventure
6,2015,Star Wars: Episode VII - The Force Awakens,306000000,"$936,662,225",2053311220,1747311220,Star Wars: Episode VII - The Force Awakens,2015,Action/Adventure
34,2015,Jurassic World,215000000,"$652,270,625",1648854864,1433854864,Jurassic World,2015,Action/Adventure
27,2012,The Avengers,225000000,"$623,279,547",1517935897,1292935897,The Avengers,2012,Action/Adventure
42,2018,Black Panther,200000000,"$700,059,566",1348258224,1148258224,Black Panther,2018,Action/Adventure
13,2018,Jurassic World: Fallen Kingdom,170000000,"$417,719,760",1305772799,1135772799,Jurassic World: Fallen Kingdom,2018,Action/Adventure
61,2011,Harry Potter and the Deathly Hallows: Part 2,125000000,"$381,193,157",1341693157,1216693157,Harry Potter and the Deathly Hallows: Part 2,2011,Drama
4,2015,Avengers: Age of Ultron,330600000,"$459,005,868",1403013963,1072413963,Avengers: Age of Ultron,2015,Action/Adventure
56,2013,Frozen,150000000,"$400,738,009",1272469910,1122469910,Frozen,2013,Family/Animation
67,2015,Furious 7,190000000,"$353,007,020",1518722794,1328722794,Furious 7,2015,Action/Thriller
48,2013,Iron Man 3,200000000,"$408,992,272",1215392272,1015392272,Iron Man 3,2013,Action/Adventure
35,2017,Beauty and the Beast,160000000,"$504,014,165",1259199706,1099199706,Beauty and the Beast,2017,Family/Animation
23,2017,The Fate of the Furious,250000000,"$225,764,765",1234846267,984846267,The Fate of the Furious,2017,Action/Thriller
5,2017,Star Wars: The Last Jedi,317000000,"$620,181,382",1316721747,999721747,Star Wars: The Last Jedi,2017,Action/Adventure
73,2015,Minions,74000000,"$336,045,770",1160336173,1086336173,Minions,2015,Family/Animation
44,2018,Incredibles 2,200000000,"$608,581,744",1242520711,1042520711,Incredibles 2,2018,Family/Animation
30,2017,Despicable Me 3,75000000,"$264,624,300",1034727750,959727750,Despicable Me 3,2017,Family/Animation
22,2013,Despicable Me 2,76000000,"$368,065,385",975216835,899216835,Despicable Me 2,2013,Family/Animation
36,2018,Aquaman,160000000,"$335,061,807",1146894640,986894640,Aquaman,2018,Action/Adventure
96,2019,Captain Marvel,175000000,"$426,525,952",1123061550,948061550,Captain Marvel,2019,Action/Adventure
64,2011,Transformers: Dark of the Moon,195000000,"$352,390,543",1123790543,928790543,Transformers: Dark of the Moon,2011,Action/Adventure
37,2014,Transformers: Age of Extinction,210000000,"$245,439,076",1104039076,894039076,Transformers: Age of Extinction,2014,Action/Adventure
17,2016,Captain America: Civil War,250000000,"$408,084,349",1140069413,890069413,Captain America: Civil War,2016,Action/Adventure
57,2016,Zootopia,150000000,"$341,268,248",1019429616,869429616,Zootopia,2016,Family/Animation
47,2010,Toy Story 3,200000000,"$415,004,880",1068879522,868879522,Toy Story 3,2010,Family/Animation
38,2017,Jumanji: Welcome to the Jungle,90000000,"$404,508,916",964496193,874496193,Jumanji: Welcome to the Jungle,2017,Action/Adventure
45,2016,Rogue One: A Star Wars Story,200000000,"$532,177,324",1049102856,849102856,Rogue One: A Star Wars Story,2016,Action/Adventure
51,2010,Alice in Wonderland,200000000,"$334,191,110",1025491110,825491110,Alice in Wonderland,2010,Family/Animation
52,2012,Skyfall,200000000,"$304,360,277",1110526981,910526981,Skyfall,2012,Action/Thriller
64,2010,Harry Potter and the Deathly Hallows: Part 1,125000000,"$296,131,568",960431568,835431568,Harry Potter and the Deathly Hallows: Part 1,2010,Action/Adventure
56,2016,Deadpool,58000000,"$363,070,709",801025593,743025593,Deadpool,2016,Action/Adventure
38,2013,The Hunger Games: Catching Fire,130000000,"$424,668,047",864868047,734868047,The Hunger Games: Catching Fire,2013,Action/Adventure
46,2016,Finding Dory,200000000,"$486,295,561",1021215193,821215193,Finding Dory,2016,Family/Animation
11,2012,The Dark Knight Rises,275000000,"$448,139,099",1084439099,809439099,The Dark Knight Rises,2012,Action/Thriller
21,2013,The Hobbit: The Desolation of Smaug,250000000,"$258,366,855",960366855,710366855,The Hobbit: The Desolation of Smaug,2013,Action/Adventure
99,2017,Spider-Man: Homecoming,175000000,"$334,201,140",880166350,705166350,Spider-Man: Homecoming,2017,Action/Adventure
22,2014,The Hobbit: The Battle of the Five Armies,250000000,"$255,119,788",945577621,695577621,The Hobbit: The Battle of the Five Armies,2014,Action/Adventure
15,2018,Deadpool 2,110000000,"$324,591,735",786680557,676680557,Deadpool 2,2018,Action/Adventure
26,2016,The Secret Life of Pets,75000000,"$368,384,330",886750534,811750534,The Secret Life of Pets,2016,Family/Animation
97,2016,The Jungle Book,175000000,"$364,001,123",962854547,787854547,The Jungle Book,2016,Family/Animation
14,2012,Ice Age: Continental Drift,95000000,"$161,321,843",879765137,784765137,Ice Age: Continental Drift,2012,Family/Animation
38,2010,Inception,160000000,"$292,576,195",835524642,675524642,Inception,2010,Action/Adventure
19,2012,The Hobbit: An Unexpected Journey,250000000,"$303,003,568",1017003568,767003568,The Hobbit: An Unexpected Journey,2012,Family/Animation
55,2017,Wonder Woman,150000000,"$412,563,408",821133378,671133378,Wonder Woman,2017,Action/Adventure
82,2017,Thor: Ragnarok,180000000,"$315,058,289",846980024,666980024,Thor: Ragnarok,2017,Action/Adventure
49,2017,Guardians of the Galaxy Vol. 2,200000000,"$389,813,101",862316233,662316233,Guardians of the Galaxy Vol. 2,2017,Action/Adventure
62,2014,The Hunger Games: Mockingjay - Part 1,125000000,"$337,135,885",766575131,641575131,The Hunger Games: Mockingjay - Part 1,2014,Action/Adventure
3,2018,Venom,116000000,"$213,511,408",853628605,737628605,Venom,2018,Action/Thriller
2,2011,Pirates of the Caribbean: On Stranger Tides,410600000,"$241,063,875",1045663875,635063875,Pirates of the Caribbean: On Stranger Tides,2011,Action/Adventure
18,2016,Batman v Superman: Dawn of Justice,250000000,"$330,360,194",867500281,617500281,Batman v Superman: Dawn of Justice,2016,Action/Adventure
14,2014,Guardians of the Galaxy,170000000,"$333,172,112",770867516,600867516,Guardians of the Galaxy,2014,Action/Adventure
38,2012,The Hunger Games,80000000,"$408,010,692",677923379,597923379,The Hunger Games,2012,Action/Adventure
98,2015,Inside Out,175000000,"$356,461,711",854235992,679235992,Inside Out,2015,Family/Animation
2,2017,Coco,175000000,"$209,726,015",798008101,623008101,Coco,2017,Family/Animation
100,2016,Suicide Squad,175000000,"$325,100,054",746059887,571059887,Suicide Squad,2016,Action/Adventure
57,2011,The Twilight Saga: Breaking Dawn - Part 1,127500000,"$281,287,133",689420051,561920051,The Twilight Saga: Breaking Dawn - Part 1,2011,Drama
85,2016,Fantastic Beasts and Where to Find Them,180000000,"$234,037,575",802402853,622402853,Fantastic Beasts and Where to Find Them,2016,Family/Animation
40,2013,Fast & Furious 6,160000000,"$238,679,850",789300444,629300444,Fast & Furious 6,2013,Action/Thriller
25,2017,Pirates of the Caribbean: Dead Men Tell No Tales,230000000,"$172,558,876",788241137,558241137,Pirates of the Caribbean: Dead Men Tell No Tales,2017,Action/Adventure
97,2012,Madagascar 3: Europe's Most Wanted,145000000,"$216,391,482",746921271,601921271,Madagascar 3: Europe's Most Wanted,2012,Family/Animation
27,2010,Shrek Forever After,165000000,"$238,736,787",756244673,591244673,Shrek Forever After,2010,Family/Animation
55,2014,X-Men: Days of Future Past,200000000,"$233,921,534",747862775,547862775,X-Men: Days of Future Past,2014,Action/Adventure
16,2014,Captain America: The Winter Soldier,170000000,"$259,746,958",714401889,544401889,Captain America: The Winter Soldier,2014,Action/Adventure
84,2014,Maleficent,180000000,"$241,407,328",758536735,578536735,Maleficent,2014,Family/Animation
17,2014,Dawn of the Planet of the Apes,170000000,"$208,545,589",710644566,540644566,Dawn of the Planet of the Apes,2014,Action/Adventure
31,2012,The Amazing Spider-Man,220000000,"$262,030,663",757890267,537890267,The Amazing Spider-Man,2012,Action/Adventure
29,2016,Sing,75000000,"$270,329,045",634454789,559454789,Sing,2016,Family/Animation
92,2018,Mission: Impossible - Fallout,178000000,"$220,159,104",787456552,609456552,Mission: Impossible - Fallout,2018,Action/Thriller
53,2013,Monsters University,200000000,"$268,488,329",743588329,543588329,Monsters University,2013,Family/Animation
39,2011,The Hangover Part II,80000000,"$254,464,305",586464305,506464305,The Hangover Part II,2011,Comedy
32,2014,Interstellar,165000000,"$188,017,894",666379375,501379375,Interstellar,2014,Drama
84,2018,Bohemian Rhapsody,55000000,"$216,303,339",894985342,839985342,Bohemian Rhapsody,2018,Biography/Historical
74,2011,Kung Fu Panda 2,150000000,"$165,249,063",664837547,514837547,Kung Fu Panda 2,2011,Family/Animation
24,2017,It,35000000,"$327,481,748",697457969,662457969,It,2017,Horror
62,2016,Moana,150000000,"$248,757,044",637517365,487517365,Moana,2016,Family/Animation
29,2014,Big Hero 6,165000000,"$222,527,828",652127828,487127828,Big Hero 6,2014,Family/Animation
28,2016,Doctor Strange,165000000,"$232,641,920",676404566,511404566,Doctor Strange,2016,Action/Adventure
10,2015,Spectre,300000000,"$200,074,175",879620923,579620923,Spectre,2015,Action/Thriller
50,2010,Despicable Me,69000000,"$251,513,985",543464573,474464573,Despicable Me,2010,Family/Animation
59,2017,Logan,127000000,"$226,277,068",615461394,488461394,Logan,2017,Drama
99,2014,How to Train Your Dragon 2,145000000,"$177,002,924",614586270,469586270,How to Train Your Dragon 2,2014,Family/Animation
77,2018,Hotel Transylvania 3: Summer Vacation,65000000,"$167,500,092",527079962,462079962,Hotel Transylvania 3: Summer Vacation,2018,Family/Animation
98,2011,Mission: Impossible - Ghost Protocol,145000000,"$209,397,903",694713230,549713230,Mission: Impossible - Ghost Protocol,2011,Action/Thriller
53,2010,The Twilight Saga: Eclipse,68000000,"$300,531,751",706102828,638102828,The Twilight Saga: Eclipse,2010,Drama
92,2016,La La Land,20000000,"$151,101,803",426351163,406351163,La La Land,2016,Dramedy
56,2014,The Amazing Spider-Man 2,200000000,"$202,853,933",708996336,508996336,The Amazing Spider-Man 2,2014,Action/Adventure
66,2013,Thor: The Dark World,150000000,"$206,362,140",644602516,494602516,Thor: The Dark World,2013,Action/Adventure
41,2018,Ant-Man and the Wasp,130000000,"$216,648,740",623144660,493144660,Ant-Man and the Wasp,2018,Action/Adventure
25,2012,The Twilight Saga: Breaking Dawn - Part 2,136200000,"$292,324,737",829724737,693524737,The Twilight Saga: Breaking Dawn - Part 2,2012,Drama
68,2015,Mission: Impossible - Rogue Nation,150000000,"$195,042,377",688858992,538858992,Mission: Impossible - Rogue Nation,2015,Action/Thriller
20,2011,The Smurfs,110000000,"$142,614,158",563749323,453749323,The Smurfs,2011,Family/Animation
39,2015,The Hunger Games: Mockingjay - Part 2,160000000,"$281,723,902",648986787,488986787,The Hunger Games: Mockingjay - Part 2,2015,Action/Adventure
60,2018,Fantastic Beasts: The Crimes of Grindelwald,200000000,"$159,555,901",652220086,452220086,Fantastic Beasts: The Crimes of Grindelwald,2018,Family/Animation
13,2015,Cinderella,95000000,"$201,151,353",534551353,439551353,Cinderella,2015,Family/Animation
26,2013,The Croods,135000000,"$187,168,425",573068425,438068425,The Croods,2013,Family/Animation
81,2019,Aladdin,182000000,"$246,734,314",619234314,437234314,Aladdin,2019,Family/Animation
67,2011,Fast Five,125000000,"$210,031,325",630163454,505163454,Fast Five,2011,Action/Thriller
28,2018,The Grinch,75000000,"$270,620,950",511002426,436002426,The Grinch,2018,Family/Animation
15,2010,Iron Man 2,170000000,"$312,433,331",621156389,451156389,Iron Man 2,2010,Action/Adventure
46,2011,Puss in Boots,130000000,"$149,260,504",554987477,424987477,Puss in Boots,2011,Family/Animation
29,2013,Man of Steel,225000000,"$291,045,518",667999518,442999518,Man of Steel,2013,Action/Adventure
69,2011,Sherlock Holmes: A Game of Shadows,125000000,"$186,848,418",535663443,410663443,Sherlock Holmes: A Game of Shadows,2011,Crime/Mystery
57,2014,American Sniper,58000000,"$350,126,372",547326372,489326372,American Sniper,2014,Biography/Historical
35,2012,Men in Black 3,215000000,"$179,020,854",654213485,439213485,Men in Black 3,2012,Action/Adventure
78,2018,Ready Player One,150000000,"$137,690,172",579290136,429290136,Ready Player One,2018,Action/Adventure
16,2013,Gravity,110000000,"$274,092,705",693698673,583698673,Gravity,2013,Drama
43,2015,Ant-Man,130000000,"$180,202,163",518858449,388858449,Ant-Man,2015,Action/Adventure
44,2014,The Lego Movie,60000000,"$257,784,718",457729388,397729388,The Lego Movie,2014,Family/Animation
18,2011,The Intouchables,10800000,"$13,182,281",484873045,474073045,The Intouchables,2011,Dramedy
33,2017,Transformers: The Last Knight,217000000,"$130,168,683",602893340,385893340,Transformers: The Last Knight,2017,Action/Adventure
46,2011,Rio,90000000,"$143,619,809",487519809,397519809,Rio,2011,Family/Animation
83,2014,Lucy,40000000,"$126,573,960",457507776,417507776,Lucy,2014,Action/Thriller
56,2019,How to Train Your Dragon: The Hidden World,129000000,"$160,791,800",519258283,390258283,How to Train Your Dragon: The Hidden World,2019,Family/Animation
78,2017,Kong: Skull Island,185000000,"$168,052,812",561072059,376072059,Kong: Skull Island,2017,Action/Adventure
41,2014,Godzilla,160000000,"$200,676,069",529076069,369076069,Godzilla,2014,Action/Adventure
46,2015,The Martian,108000000,"$228,433,663",655271443,547271443,The Martian,2015,Drama
72,2010,Clash of the Titans,125000000,"$163,214,888",493214888,368214888,Clash of the Titans,2010,Action/Adventure
93,2016,X-Men: Apocalypse,178000000,"$155,442,489",542537546,364537546,X-Men: Apocalypse,2016,Action/Adventure
78,2015,Fifty Shades of Grey,40000000,"$166,167,230",570998101,530998101,Fifty Shades of Grey,2015,Drama
62,2018,Bumblebee,102000000,"$127,195,589",465195589,363195589,Bumblebee,2018,Action/Adventure
42,2015,Hotel Transylvania 2,80000000,"$169,700,110",469500298,389500298,Hotel Transylvania 2,2015,Family/Animation
94,2018,The Meg,178000000,"$145,443,742",529530715,351530715,The Meg,2018,Horror
68,2014,Teenage Mutant Ninja Turtles,125000000,"$191,204,754",485004754,360004754,Teenage Mutant Ninja Turtles,2014,Action/Adventure
71,2017,The Boss Baby,125000000,"$175,003,033",510878762,385878762,The Boss Baby,2017,Family/Animation
11,2016,Kung Fu Panda 3,140000000,"$143,528,619",517599142,377599142,Kung Fu Panda 3,2016,Family/Animation
69,2013,World War Z,190000000,"$202,359,711",531514650,341514650,World War Z,2013,Horror
77,2012,Brave,185000000,"$237,282,182",554606532,369606532,Brave,2012,Family/Animation
49,2014,Rio 2,130000000,"$131,538,435",492846291,362846291,Rio 2,2014,Family/Animation
9,2017,Justice League,300000000,"$229,024,295",655945209,355945209,Justice League,2017,Action/Adventure
69,2017,Dunkirk,150000000,"$190,068,280",499837368,349837368,Dunkirk,2017,Biography/Historical
57,2011,Cars 2,200000000,"$191,450,875",560155383,360155383,Cars 2,2011,Family/Animation
19,2015,San Andreas,110000000,"$155,190,832",456258539,346258539,San Andreas,2015,Action/Adventure
3,2018,Ralph Breaks the Internet,175000000,"$201,091,711",524283695,349283695,Ralph Breaks the Internet,2018,Family/Animation
52,2017,War for the Planet of the Apes,152000000,"$146,880,162",489592267,337592267,War for the Planet of the Apes,2017,Action/Adventure
31,2012,Wreck-It Ralph,165000000,"$189,412,677",496511521,331511521,Wreck-It Ralph,2012,Family/Animation
88,2012,Life of Pi,120000000,"$124,987,022",620912003,500912003,Life of Pi,2012,Drama
84,2012,Ted,50000000,"$218,665,740",556016627,506016627,Ted,2012,Comedy
29,2014,Kingsman: The Secret Service,94000000,"$128,261,724",404561724,310561724,Kingsman: The Secret Service,2014,Action/Adventure
90,2018,Rampage,120000000,"$101,028,233",428056280,308056280,Rampage,2018,Action/Adventure
27,2015,The Revenant,135000000,"$183,637,894",532938302,397938302,The Revenant,2015,Drama
30,2010,How to Train Your Dragon,165000000,"$217,581,232",494870992,329870992,How to Train Your Dragon,2010,Family/Animation
54,2017,Kingsman: The Golden Circle,104000000,"$100,234,838",408803696,304803696,Kingsman: The Golden Circle,2017,Action/Adventure
15,2010,Tangled,260000000,"$200,821,936",586477240,326477240,Tangled,2010,Family/Animation
31,2011,Rise of the Planet of the Apes,93000000,"$176,760,185",470986200,377986200,Rise of the Planet of the Apes,2011,Drama
8,2013,The Wolverine,115000000,"$132,556,852",416456852,301456852,The Wolverine,2013,Action/Adventure
70,2011,Thor,150000000,"$181,030,624",449326618,299326618,Thor,2011,Action/Adventure
54,2012,Taken 2,45000000,"$139,854,287",377807404,332807404,Taken 2,2012,Action/Thriller
97,2019,Shazam!,85000000,"$139,606,856",362899733,277899733,Shazam!,2019,Action/Adventure
76,2013,The Wolf of Wall Street,100000000,"$116,900,694",389870414,289870414,The Wolf of Wall Street,2013,Dramedy
68,2013,Star Trek Into Darkness,190000000,"$228,778,661",467381584,277381584,Star Trek Into Darkness,2013,Action/Adventure
49,2015,Terminator Genisys,155000000,"$89,760,956",432150894,277150894,Terminator Genisys,2015,Action/Adventure
77,2010,The Karate Kid,40000000,"$176,591,618",351774938,311774938,The Karate Kid,2010,Family/Animation
46,2016,Warcraft,160000000,"$47,225,655",425522281,265522281,Warcraft,2016,Action/Adventure
10,2012,Journey 2: The Mysterious Island,79000000,"$103,860,290",318146162,239146162,Journey 2: The Mysterious Island,2012,Action/Adventure
36,2014,Gone Girl,61000000,"$167,767,189",368567189,307567189,Gone Girl,2014,Crime/Mystery
57,2013,The Hangover Part III,103000000,"$112,200,072",362000072,259000072,The Hangover Part III,2013,Comedy
52,2016,Ice Age: Collision Course,105000000,"$64,063,008",402156682,297156682,Ice Age: Collision Course,2016,Family/Animation
97,2018,Peter Rabbit,50000000,"$115,234,093",347136477,297136477,Peter Rabbit,2018,Family/Animation
66,2018,A Quiet Place,17000000,"$188,024,361",334522294,317522294,A Quiet Place,2018,Horror
96,2012,Hotel Transylvania,85000000,"$148,313,048",378505812,293505812,Hotel Transylvania,2012,Family/Animation
66,2016,Now You See Me 2,90000000,"$65,075,540",328325007,238325007,Now You See Me 2,2016,Action/Adventure
13,2013,G.I. Joe: Retaliation,140000000,"$122,523,060",375740705,235740705,G.I. Joe: Retaliation,2013,Action/Adventure
24,2019,Alita: Battle Angel,170000000,"$85,710,210",402976036,232976036,Alita: Battle Angel,2019,Action/Adventure
5,2018,A Star Is Born,36000000,"$215,288,866",433449571,397449571,A Star Is Born,2018,Drama
54,2013,Oz the Great and Powerful,200000000,"$234,770,996",490359051,290359051,Oz the Great and Powerful,2013,Family/Animation
19,2012,Snow White and the Huntsman,170000000,"$155,136,755",401021746,231021746,Snow White and the Huntsman,2012,Action/Adventure
44,2018,Spider-Man: Into the Spider-Verse,90000000,"$190,173,195",375381768,285381768,Spider-Man: Into the Spider-Verse,2018,Family/Animation
10,2011,Captain America: The First Avenger,140000000,"$176,654,505",370569776,230569776,Captain America: The First Avenger,2011,Action/Adventure
69,2012,Django Unchained,100000000,"$162,805,434",449948323,349948323,Django Unchained,2012,Drama
97,2010,The King's Speech,15000000,"$138,797,449",430821168,415821168,The King's Speech,2010,Biography/Historical
78,2012,Les Miserables,65000000,"$148,809,770",442169052,377169052,,,Drama
95,2017,Wonder,20000000,"$132,422,809",304604712,284604712,Wonder,2017,Family/Animation
63,2012,The Lorax,67500000,"$214,030,500",350976753,283476753,The Lorax,2012,Family/Animation
51,2014,Noah,130000000,"$101,200,044",352831065,222831065,Noah,2014,Action/Adventure
72,2013,Pacific Rim,190000000,"$101,802,906",411002906,221002906,Pacific Rim,2013,Action/Adventure
93,2013,The Conjuring,20000000,"$137,400,141",318000141,298000141,The Conjuring,2013,Horror
77,2016,The Angry Birds Movie,73000000,"$107,509,366",352327887,279327887,The Angry Birds Movie,2016,Family/Animation
26,2014,300: Rise of an Empire,110000000,"$106,580,051",330780051,220780051,300: Rise of an Empire,2014,Action/Adventure
75,2015,Mad Max: Fury Road,150000000,"$153,636,354",370098020,220098020,Mad Max: Fury Road,2015,Action/Adventure
70,2013,The Great Gatsby,190000000,"$144,840,419",351040419,161040419,The Great Gatsby,2013,Drama
33,2016,Independence Day: Resurgence,165000000,"$103,144,286",384169424,219169424,Independence Day: Resurgence,2016,Action/Adventure
65,2017,The Mummy,195000000,"$80,101,125",409953905,214953905,The Mummy,2017,Action/Adventure
58,2010,TRON: Legacy,200000000,"$172,062,763",400062763,200062763,TRON: Legacy,2010,Action/Adventure
49,2011,Alvin and the Chipmunks: Chipwrecked,80000000,"$133,107,389",349088523,269088523,Alvin and the Chipmunks: Chipwrecked,2011,Family/Animation
48,2010,The Chronicles of Narnia: The Voyage of the Dawn Treader,155000000,"$104,386,950",418186950,263186950,The Chronicles of Narnia: The Voyage of the Dawn Treader,2010,Family/Animation
42,2011,X-Men: First Class,160000000,"$146,408,305",355408305,195408305,X-Men: First Class,2011,Action/Adventure
25,2017,The Greatest Showman,84000000,"$174,340,174",386665550,302665550,The Greatest Showman,2017,Biography/Historical
76,2019,Pokemon: Detective Pikachu,150000000,"$139,507,806",411258433,261258433,,,Family/Animation
85,2011,Bridesmaids,32500000,"$169,211,718",289632023,257132023,Bridesmaids,2011,Comedy
44,2015,Home,130000000,"$177,397,510",385997896,255997896,Home,2015,Family/Animation
60,2014,The Maze Runner,34000000,"$102,427,862",348319861,314319861,The Maze Runner,2014,Action/Thriller
52,2011,The Adventures of Tintin,130000000,"$77,591,831",373993951,243993951,The Adventures of Tintin,2011,Family/Animation
86,2016,Jason Bourne,120000000,"$162,192,920",416168316,296168316,Jason Bourne,2016,Action/Thriller
33,2013,The Smurfs 2,110000000,"$71,017,784",348547523,238547523,The Smurfs 2,2013,Family/Animation
95,2014,Edge of Tomorrow,178000000,"$100,206,256",370541256,192541256,Edge of Tomorrow,2014,Action/Adventure
95,2014,Divergent,85000000,"$150,947,895",276014965,191014965,Divergent,2014,Action/Adventure
85,2014,22 Jump Street,50000000,"$191,719,337",331333876,281333876,22 Jump Street,2014,Crime/Mystery
74,2015,The SpongeBob Movie: Sponge Out of Water,74000000,"$162,994,032",311013181,237013181,The SpongeBob Movie: Sponge Out of Water,2015,Family/Animation
37,2014,Penguins of Madagascar,132000000,"$83,350,911",366942531,234942531,Penguins of Madagascar,2014,Family/Animation
31,2011,Real Steel,110000000,"$85,463,309",263880341,153880341,Real Steel,2011,Drama
22,2015,Insurgent,110000000,"$130,179,072",295075882,185075882,Insurgent,2015,Action/Adventure
18,2014,Taken 3,48000000,"$89,256,424",327656424,279656424,Taken 3,2014,Action/Thriller
2,2017,Annabelle: Creation,15000000,"$102,092,201",305384865,290384865,Annabelle: Creation,2017,Horror
15,2017,xXx: Return of Xander Cage,85000000,"$44,898,413",345033359,260033359,xXx: Return of Xander Cage,2017,Action/Thriller
41,2017,The Lego Batman Movie,80000000,"$175,750,384",310660018,230660018,The Lego Batman Movie,2017,Family/Animation
46,2010,Black Swan,13000000,"$106,954,678",331266710,318266710,Black Swan,2010,Drama
51,2011,The Girl with the Dragon Tattoo,90000000,"$102,515,793",239373970,149373970,The Girl with the Dragon Tattoo,2011,Crime/Mystery
29,2011,The Green Hornet,110000000,"$98,780,042",229155503,119155503,The Green Hornet,2011,Crime/Mystery
43,2014,The Fault in Our Stars,12000000,"$124,872,350",307166834,295166834,The Fault in Our Stars,2014,Drama
97,2018,Fifty Shades Freed,55000000,"$100,407,760",371350619,316350619,Fifty Shades Freed,2018,Drama
60,2014,Night at the Museum: Secret of the Tomb,127000000,"$113,746,621",353756621,226756621,Night at the Museum: Secret of the Tomb,2014,Family/Animation
41,2013,Now You See Me,75000000,"$117,723,989",342769200,267769200,Now You See Me,2013,Crime/Mystery
75,2012,Prometheus,125000000,"$126,477,084",402448265,277448265,Prometheus,2012,Horror
70,2018,Tomb Raider,90000000,"$58,250,803",273477501,183477501,Tomb Raider,2018,Action/Adventure
27,2011,Bad Teacher,19000000,"$100,292,856",215448997,196448997,Bad Teacher,2011,Comedy
88,2016,The Legend of Tarzan,180000000,"$126,643,061",348902025,168902025,The Legend of Tarzan,2016,Action/Adventure
93,2013,Oblivion,120000000,"$89,107,235",287916633,167916633,Oblivion,2013,Action/Adventure
58,2011,Just Go with It,80000000,"$103,028,109",214974953,134974953,Just Go with It,2011,Comedy
91,2017,Fifty Shades Darker,55000000,"$114,434,010",381398492,326398492,Fifty Shades Darker,2017,Drama
64,2014,Neighbors,18000000,"$150,086,800",270944428,252944428,Neighbors,2014,Comedy
87,2012,Wrath of the Titans,150000000,"$83,670,083",305270083,155270083,Wrath of the Titans,2012,Action/Adventure
73,2016,Trolls,125000000,"$153,707,064",344150134,219150134,Trolls,2016,Family/Animation
79,2016,Star Trek Beyond,185000000,"$158,848,340",335802233,150802233,Star Trek Beyond,2016,Action/Adventure
63,2011,The Help,25000000,"$169,705,587",213120004,188120004,The Help,2011,Drama
95,2017,Murder on the Orient Express,55000000,"$102,826,543",345922730,290922730,Murder on the Orient Express,2017,Crime/Mystery
10,2011,Battle Los Angeles,70000000,"$83,552,429",213463976,143463976,Battle Los Angeles,2011,Action/Adventure
45,2018,Mary Poppins Returns,130000000,"$171,958,438",341528518,211528518,Mary Poppins Returns,2018,Family/Animation
5,2017,Cars 3,175000000,"$152,901,115",383541369,208541369,Cars 3,2017,Family/Animation
84,2014,Hercules,100000000,"$72,688,614",243388614,143388614,Hercules,2014,Action/Adventure
5,2014,Paddington,55000000,"$76,223,578",258789097,203789097,Paddington,2014,Family/Animation
13,2013,Cloudy with a Chance of Meatballs 2,78000000,"$119,793,567",274392649,196392649,Cloudy with a Chance of Meatballs 2,2013,Family/Animation
84,2016,Resident Evil: The Final Chapter,40000000,"$26,844,692",314101190,274101190,Resident Evil: The Final Chapter,2016,Horror
38,2015,Maze Runner: The Scorch Trials,61000000,"$81,697,192",310566162,249566162,Maze Runner: The Scorch Trials,2015,Action/Thriller
81,2019,John Wick: Chapter 3 - Parabellum,40000000,"$141,744,320",256498033,216498033,John Wick: Chapter 3 - Parabellum,2019,Action/Thriller
2,2010,Knight and Day,117000000,"$76,423,035",258751370,141751370,Knight and Day,2010,Action/Adventure
28,2016,Passengers,110000000,"$100,014,699",302239672,192239672,Passengers,2016,Drama
30,2016,Miss Peregrine's Home for Peculiar Children,110000000,"$87,242,834",295986876,185986876,Miss Peregrine's Home for Peculiar Children,2016,Drama
56,2016,Dangal,9500000,"$12,391,761",294654618,285154618,Dangal,2016,Biography/Historical
47,2010,Megamind,130000000,"$148,415,853",321887208,191887208,Megamind,2010,Family/Animation
4,2013,Planes,50000000,"$90,282,580",238059569,188059569,Planes,2013,Family/Animation
34,2013,A Good Day to Die Hard,92000000,"$67,349,198",304249198,212249198,A Good Day to Die Hard,2013,Action/Thriller
63,2010,Prince of Persia: The Sands of Time,200000000,"$90,759,676",336359676,136359676,Prince of Persia: The Sands of Time,2010,Action/Adventure
14,2017,Ferdinand,111000000,"$84,410,380",289847930,178847930,Ferdinand,2017,Family/Animation
50,2018,Pacific Rim: Uprising,155000000,"$59,874,525",290930148,135930148,Pacific Rim: Uprising,2018,Action/Adventure
92,2017,The Great Wall,150000000,"$45,157,105",334486852,184486852,The Great Wall,2017,Biography/Historical
92,2013,Elysium,120000000,"$93,050,117",286192091,166192091,Elysium,2013,Drama
22,2019,Dumbo,170000000,"$113,883,318",345004422,175004422,Dumbo,2019,Family/Animation
34,2011,Horrible Bosses,35000000,"$117,538,559",212417601,177417601,Horrible Bosses,2011,Comedy
45,2011,Immortals,75000000,"$83,504,017",211562435,136562435,Immortals,2011,Drama
50,2016,Split,5000000,"$138,141,585",278964806,273964806,Split,2016,Horror
71,2018,Green Book,23000000,"$85,080,171",322034439,299034439,Green Book,2018,Dramedy
81,2012,The Expendables 2,100000000,"$85,028,192",311979256,211979256,The Expendables 2,2012,Action/Thriller
25,2019,Godzilla: King of the Monsters,170000000,"$85,576,941",299276941,129276941,Godzilla: King of the Monsters,2019,Action/Adventure
83,2010,The Last Airbender,150000000,"$131,772,187",319713881,169713881,The Last Airbender,2010,Family/Animation
90,2016,The Conjuring 2,40000000,"$102,470,008",311262102,271262102,The Conjuring 2,2016,Horror
7,2017,The Emoji Movie,50000000,"$86,089,513",216562312,166562312,The Emoji Movie,2017,Family/Animation
14,2015,Pitch Perfect 2,29000000,"$184,296,230",287625468,258625468,Pitch Perfect 2,2015,Comedy
77,2013,Epic,100000000,"$107,518,682",262794441,162794441,Epic,2013,Family/Animation
2,2012,Rise of the Guardians,145000000,"$103,412,758",306900902,161900902,Rise of the Guardians,2012,Family/Animation
90,2013,We're the Millers,37000000,"$150,394,119",267816276,230816276,We're the Millers,2013,Comedy
56,2015,Alvin and the Chipmunks: The Road Chip,90000000,"$85,886,987",249517956,159517956,Alvin and the Chipmunks: The Road Chip,2015,Family/Animation
93,2011,Super 8,50000000,"$127,004,179",257972745,207972745,Super 8,2011,Action/Thriller
16,2014,Exodus: Gods and Kings,140000000,"$65,014,513",268314513,128314513,Exodus: Gods and Kings,2014,Action/Adventure
53,2013,After Earth,130000000,"$60,522,097",251499665,121499665,After Earth,2013,Action/Adventure
50,2016,Sully,60000000,"$125,070,033",238524556,178524556,Sully,2016,Biography/Historical
49,2017,Get Out,5000000,"$176,040,665",255367951,250367951,Get Out,2017,Horror
64,2016,Hidden Figures,25000000,"$169,607,287",231771716,206771716,Hidden Figures,2016,Biography/Historical
70,2010,Little Fockers,100000000,"$148,438,600",310650574,210650574,Little Fockers,2010,Comedy
99,2018,Ocean's Eight,70000000,"$140,218,711",297115976,227115976,Ocean's Eight,2018,Crime/Mystery
6,2011,Gnomeo and Juliet,36000000,"$99,967,670",193737977,157737977,,,Family/Animation
84,2014,Annabelle,6500000,"$84,273,813",256862920,250362920,Annabelle,2014,Horror
4,2016,Ghostbusters,144000000,"$128,350,574",229008658,85008658,Ghostbusters,2016,Comedy
19,2011,Johnny English Reborn,45000000,"$8,406,711",164640401,119640401,Johnny English Reborn,2011,Action/Adventure
80,2013,American Hustle,40000000,"$150,117,807",257878294,217878294,American Hustle,2013,Dramedy
12,2018,Solo: A Star Wars Story,275000000,"$213,767,512",393151347,118151347,Solo: A Star Wars Story,2018,Action/Adventure
64,2016,Inferno,75000000,"$34,343,574",219519367,144519367,Inferno,2016,Crime/Mystery
31,2013,Turbo,135000000,"$83,028,130",286896578,151896578,Turbo,2013,Family/Animation
80,2016,Assassin's Creed,125000000,"$54,647,948",240759682,115759682,Assassin's Creed,2016,Action/Adventure
7,2015,The Peanuts Movie,99000000,"$130,178,411",250091610,151091610,The Peanuts Movie,2015,Family/Animation
91,2016,Central Intelligence,50000000,"$127,440,871",217194805,167194805,Central Intelligence,2016,Crime/Mystery
73,2015,The Good Dinosaur,187500000,"$123,087,120",333771037,146271037,The Good Dinosaur,2015,Family/Animation
36,2018,Halloween,10000000,"$159,342,015",254900667,244900667,Halloween,2018,Horror
39,2010,Robin Hood,210000000,"$105,487,148",322459006,112459006,Robin Hood,2010,Action/Adventure
32,2016,Teenage Mutant Ninja Turtles: Out of the Shadows,135000000,"$82,051,601",245328374,110328374,Teenage Mutant Ninja Turtles: Out of the Shadows,2016,Action/Adventure
40,2014,Into the Storm,50000000,"$47,602,194",150429371,100429371,Into the Storm,2014,Action/Adventure
20,2016,Me Before You,20000000,"$56,245,075",208265198,188265198,Me Before You,2016,Drama
70,2010,Resident Evil: Afterlife,57500000,"$60,128,566",295874190,238374190,Resident Evil: Afterlife,2010,Horror
5,2017,Smurfs: The Lost Village,60000000,"$45,020,282",197578586,137578586,Smurfs: The Lost Village,2017,Family/Animation
40,2018,The Death Cure,61000000,"$58,032,443",265878536,204878536,The Death Cure,2018,Action/Thriller
48,2013,Grown Ups 2,80000000,"$133,668,525",247023808,167023808,Grown Ups 2,2013,Comedy
9,2011,Mr. Popper's Penguins,55000000,"$68,224,452",189624452,134624452,Mr. Popper's Penguins,2011,Family/Animation
88,2019,Us,20000000,"$175,006,930",254210310,234210310,Us,2019,Horror
3,2016,Bridget Jones's Baby,35000000,"$24,139,805",205822688,170822688,Bridget Jones's Baby,2016,Dramedy
34,2016,Arrival,47000000,"$100,546,139",203127894,156127894,Arrival,2016,Crime/Mystery
69,2018,Smallfoot,80000000,"$83,240,103",213691277,133691277,Smallfoot,2018,Family/Animation
34,2010,The Expendables,82000000,"$103,068,524",268268174,186268174,The Expendables,2010,Action/Thriller
82,2010,The Secret World of Arrietty,23000000,"$19,192,510",151496097,128496097,The Secret World of Arrietty,2010,Family/Animation
38,2018,Crazy Rich Asians,30000000,"$174,532,921",238099711,208099711,Crazy Rich Asians,2018,Comedy
78,2018,Skyscraper,125000000,"$68,420,120",304115534,179115534,Skyscraper,2018,Action/Thriller
6,2014,The Imitation Game,15000000,"$91,125,143",227740463,212740463,The Imitation Game,2014,Biography/Historical
85,2010,The Tourist,100000000,"$67,631,157",278731369,178731369,The Tourist,2010,Action/Thriller
59,2015,Pixels,90000000,"$78,765,986",244041804,154041804,Pixels,2015,Comedy
88,2015,Daddy's Home,50000000,"$150,357,137",242757137,192757137,Daddy's Home,2015,Comedy
83,2015,Spy,65000000,"$110,825,712",232585748,167585748,Spy,2015,Crime/Mystery
17,2010,Percy Jackson & the Olympians: The Lightning Thief,95000000,"$88,768,303",223050874,128050874,Percy Jackson & the Olympians: The Lightning Thief,2010,Family/Animation
2,2014,Non-Stop,50000000,"$91,742,160",222383055,172383055,Non-Stop,2014,Action/Thriller
16,2010,Sex and the City 2,95000000,"$95,347,692",294680778,199680778,Sex and the City 2,2010,Dramedy
27,2011,Hop,63000000,"$108,085,305",188657593,125657593,Hop,2011,Family/Animation
55,2017,Baahubali 2: The Conclusion,30000000,"$18,985,794",263502914,233502914,Baahubali 2: The Conclusion,2017,Drama
80,2017,Blade Runner 2049,185000000,"$92,054,159",259357408,74357408,Blade Runner 2049,2017,Crime/Mystery
3,2015,Everest,65000000,"$43,482,270",221297061,156297061,Everest,2015,Biography/Historical
52,2010,Shutter Island,80000000,"$128,012,934",299461782,219461782,Shutter Island,2010,Horror
96,2018,Creed II,50000000,"$115,715,889",213591522,163591522,Creed II,2018,Drama
21,2014,Dracula Untold,70000000,"$55,991,880",220241723,150241723,Dracula Untold,2014,Drama
77,2014,Into the Woods,56200000,"$128,002,372",213116401,156916401,Into the Woods,2014,Dramedy
28,2011,I Am Number Four,50000000,"$55,100,437",146195159,96195159,I Am Number Four,2011,Action/Adventure
51,2011,Paranormal Activity 3,5000000,"$104,028,807",207039844,202039844,Paranormal Activity 3,2011,Horror
35,2013,The Heat,43000000,"$159,581,587",229727774,186727774,The Heat,2013,Crime/Mystery
68,2014,Fury,80000000,"$85,817,906",210315681,130315681,Fury,2014,Drama
92,2013,Captain Phillips,55000000,"$107,136,417",220648184,165648184,Captain Phillips,2013,Biography/Historical
55,2015,Ted 2,68000000,"$81,476,385",217214143,149214143,Ted 2,2015,Comedy
1,2014,Mr. Peabody & Sherman,145000000,"$111,506,430",269806430,124806430,Mr. Peabody & Sherman,2014,Family/Animation
50,2010,Salt,130000000,"$118,311,368",290650494,160650494,Salt,2010,Action/Thriller
62,2010,Yogi Bear,80000000,"$100,246,011",204774690,124774690,Yogi Bear,2010,Family/Animation
43,2018,Christopher Robin,75000000,"$99,215,042",197504758,122504758,Christopher Robin,2018,Family/Animation
68,2012,Jack Reacher,60000000,"$80,070,736",217370736,157370736,Jack Reacher,2012,Action/Thriller
2,2014,The Other Woman,40000000,"$83,911,193",195111193,155111193,The Other Woman,2014,Comedy
73,2012,Lincoln,65000000,"$182,207,973",273346281,208346281,Lincoln,2012,Biography/Historical
4,2012,Resident Evil: Retribution,65000000,"$42,345,531",240647629,175647629,Resident Evil: Retribution,2012,Horror
99,2016,Bad Moms,20000000,"$113,257,297",180998716,160998716,Bad Moms,2016,Comedy
28,2016,Sausage Party,19000000,"$97,670,358",141344255,122344255,Sausage Party,2016,Family/Animation
76,2012,The Bourne Legacy,125000000,"$113,203,870",280355920,155355920,The Bourne Legacy,2012,Action/Thriller
65,2010,Paranormal Activity 2,3000000,"$84,752,907",177512032,174512032,Paranormal Activity 2,2010,Horror
59,2017,Baby Driver,34000000,"$107,825,862",228104185,194104185,Baby Driver,2017,Crime/Mystery
65,2017,The Hitman's Bodyguard,30000000,"$75,468,583",172778667,142778667,The Hitman's Bodyguard,2017,Action/Thriller
96,2014,The Equalizer,55000000,"$101,530,738",192903624,137903624,The Equalizer,2014,Action/Thriller
89,2012,Dark Shadows,150000000,"$79,727,149",238202668,88202668,Dark Shadows,2012,Comedy
13,2010,Gulliver's Travels,112000000,"$42,779,261",232017848,120017848,Gulliver's Travels,2010,Family/Animation
80,2016,London Has Fallen,60000000,"$62,524,260",195194085,135194085,London Has Fallen,2016,Action/Thriller
94,2017,John Wick: Chapter 2,40000000,"$92,029,184",171350009,131350009,John Wick: Chapter 2,2017,Action/Thriller
34,2010,Grown Ups,75000000,"$162,001,186",272223430,197223430,Grown Ups,2010,Comedy
68,2016,The Girl on the Train,45000000,"$75,395,035",174278214,129278214,The Girl on the Train,2016,Crime/Mystery
91,2011,Limitless,27000000,"$79,249,455",155564919,128564919,Limitless,2011,Action/Thriller
26,2012,American Reunion,50000000,"$56,758,835",236799211,186799211,American Reunion,2012,Comedy
32,2012,Battleship,220000000,"$65,233,400",313477717,93477717,Battleship,2012,Action/Adventure
29,2010,True Grit,35000000,"$171,243,005",252276928,217276928,True Grit,2010,Drama
59,2012,Silver Linings Playbook,21000000,"$132,092,958",236412453,215412453,Silver Linings Playbook,2012,Dramedy
35,2015,Straight Outta Compton,28000000,"$161,197,785",202182981,174182981,Straight Outta Compton,2015,Biography/Historical
6,2015,The Intern,40000000,"$75,764,672",197115710,157115710,The Intern,2015,Dramedy
35,2010,Predators,40000000,"$52,000,688",127234389,87234389,Predators,2010,Action/Adventure
27,2012,Argo,44500000,"$136,025,503",227140757,182640757,Argo,2012,Biography/Historical
64,2011,The Muppets,45000000,"$88,625,922",160971922,115971922,The Muppets,2011,Family/Animation
5,2011,The Descendants,20000000,"$82,624,961",175507800,155507800,The Descendants,2011,Dramedy
36,2018,Dragon Ball Super: Broly,8500000,"$30,376,755",122747755,114247755,Dragon Ball Super: Broly,2018,Family/Animation
70,2014,Need for Speed,66000000,"$43,568,507",194169619,128169619,Need for Speed,2014,Action/Thriller
79,2012,Total Recall,125000000,"$58,877,969",211856088,86856088,Total Recall,2012,Action/Adventure
96,2014,RoboCop,120000000,"$58,607,007",242981799,122981799,RoboCop,2014,Action/Thriller
37,2013,The Secret Life of Walter Mitty,91000000,"$58,236,838",187861183,96861183,The Secret Life of Walter Mitty,2013,Dramedy
27,2014,The Grand Budapest Hotel,31000000,"$59,076,019",163981261,132981261,The Grand Budapest Hotel,2014,Comedy
82,2014,Unbroken,65000000,"$115,637,895",163527824,98527824,Unbroken,2014,Biography/Historical
18,2013,12 Years a Slave,20000000,"$56,671,993",181025343,161025343,12 Years a Slave,2013,Biography/Historical
45,2013,Lee Daniels' The Butler,30000000,"$116,632,095",177025498,147025498,Lee Daniels' The Butler,2013,Biography/Historical
91,2015,Creed,37000000,"$109,767,581",173567581,136567581,Creed,2015,Drama
15,2016,Storks,70000000,"$72,679,278",183353431,113353431,Storks,2016,Family/Animation
91,2010,The Social Network,40000000,"$96,962,694",224922135,184922135,The Social Network,2010,Biography/Historical
64,2010,The Book of Eli,80000000,"$94,835,059",158750817,78750817,The Book of Eli,2010,Action/Adventure
74,2011,In Time,35000000,"$37,553,932",165103952,130103952,In Time,2011,Crime/Mystery
32,2013,Identity Thief,35000000,"$134,506,920",175361578,140361578,Identity Thief,2013,Comedy
99,2017,Geostorm,100000000,"$33,700,160",220796009,120796009,Geostorm,2017,Action/Thriller
21,2018,The Equalizer 2,77000000,"$102,084,362",190453132,113453132,The Equalizer 2,2018,Action/Thriller
92,2013,Anchorman 2: The Legend Continues,50000000,"$127,352,707",172185754,122185754,Anchorman 2: The Legend Continues,2013,Comedy
17,2016,Hacksaw Ridge,40000000,"$67,209,615",168904682,128904682,Hacksaw Ridge,2016,Biography/Historical
27,2013,Hansel & Gretel: Witch Hunters,50000000,"$55,703,475",214949716,164949716,Hansel & Gretel: Witch Hunters,2013,Horror
100,2018,The Mule,50000000,"$103,804,407",170857676,120857676,The Mule,2018,Drama
99,2015,Focus,65000000,"$53,862,963",168065700,103065700,Focus,2015,Dramedy
69,2016,The 5th Wave,38000000,"$34,912,982",111336398,73336398,The 5th Wave,2016,Action/Adventure
64,2013,Percy Jackson: Sea of Monsters,90000000,"$68,559,554",200859554,110859554,Percy Jackson: Sea of Monsters,2013,Family/Animation
29,2011,Rango,135000000,"$123,477,607",245724600,110724600,Rango,2011,Family/Animation
91,2016,Pete's Dragon,65000000,"$76,233,151",137768975,72768975,Pete's Dragon,2016,Action/Adventure
55,2016,The Magnificent Seven,90000000,"$93,432,655",162525156,72525156,The Magnificent Seven,2016,Action/Adventure
84,2018,The Predator,88000000,"$51,024,708",159487563,71487563,The Predator,2018,Action/Adventure
86,2017,A Dog's Purpose,25000000,"$64,321,890",203671625,178671625,A Dog's Purpose,2017,Dramedy
70,2010,Valentine's Day,52000000,"$110,485,654",217569328,165569328,Valentine's Day,2010,Comedy
3,2013,Bad Grandpa,15000000,"$102,003,019",160903019,145903019,Bad Grandpa,2013,Comedy
52,2012,Act of Valor,12000000,"$70,012,847",82497035,70497035,Act of Valor,2012,Action/Adventure
26,2016,Alice Through the Looking Glass,170000000,"$77,042,381",276928112,106928112,Alice Through the Looking Glass,2016,Family/Animation
84,2010,Due Date,65000000,"$100,539,043",211739043,146739043,Due Date,2010,Comedy
34,2016,Allegiant,110000000,"$66,184,051",172022517,62022517,Allegiant,2016,Action/Adventure
14,2014,The Monuments Men,70000000,"$78,031,620",158702748,88702748,The Monuments Men,2014,Dramedy
96,2014,The Expendables 3,100000000,"$39,322,544",209461378,109461378,The Expendables 3,2014,Action/Thriller
45,2018,Insidious: The Last Key,10000000,"$67,745,330",167885588,157885588,Insidious: The Last Key,2018,Horror
53,2013,Insidious: Chapter 2,5000000,"$83,586,447",161921515,156921515,Insidious: Chapter 2,2013,Horror
66,2013,Riddick,38000000,"$42,025,135",94763758,56763758,Riddick,2013,Action/Adventure
84,2013,Lone Survivor,40000000,"$125,095,601",149804632,109804632,Lone Survivor,2013,Biography/Historical
10,2015,Bridge of Spies,40000000,"$72,313,754",162498338,122498338,Bridge of Spies,2015,Drama
95,2011,The Grey,25000000,"$51,580,136",81249176,56249176,The Grey,2011,Action/Adventure
24,2014,Planes: Fire & Rescue,50000000,"$59,157,732",156399644,106399644,Planes: Fire & Rescue,2014,Family/Animation
99,2012,Safe House,85000000,"$126,181,630",208542162,123542162,Safe House,2012,Crime/Mystery
100,2016,The Accountant,40000000,"$86,260,045",152962083,112962083,The Accountant,2016,Crime/Mystery
44,2012,21 Jump Street,42000000,"$138,447,667",202812429,160812429,21 Jump Street,2012,Crime/Mystery
42,2012,The Vow,30000000,"$125,014,030",197618160,167618160,The Vow,2012,Drama
83,2011,Midnight in Paris,30000000,"$56,816,662",162502774,132502774,Midnight in Paris,2011,Comedy
39,2016,Don't Breathe,10000000,"$89,217,875",158973685,148973685,Don't Breathe,2016,Horror
58,2015,Goosebumps,58000000,"$80,069,458",158905324,100905324,Goosebumps,2015,Family/Animation
20,2015,Ip Man 3,36000000,"$2,679,437",157300954,121300954,Ip Man 3,2015,Biography/Historical
67,2010,Eat Pray Love,60000000,"$80,574,010",206598789,146598789,Eat Pray Love,2010,Drama
60,2016,Lion,12000000,"$51,739,495",149570720,137570720,Lion,2016,Biography/Historical
55,2016,Lights Out,5000000,"$67,268,835",148806510,143806510,Lights Out,2016,Horror
79,2012,Parental Guidance,25000000,"$77,267,296",120832383,95832383,Parental Guidance,2012,Family/Animation
72,2014,The Nut Job,30000000,"$64,251,538",122529966,92529966,The Nut Job,2014,Family/Animation
8,2019,The Lego Movie 2: The Second Part,99000000,"$105,806,508",190325698,91325698,The Lego Movie 2: The Second Part,2019,Family/Animation
1,2014,Dumb and Dumber To,40000000,"$86,208,010",156553592,116553592,Dumb and Dumber To,2014,Comedy
71,2011,Zookeeper,80000000,"$80,360,866",170805525,90805525,Zookeeper,2011,Family/Animation
96,2012,The Dictator,65000000,"$59,650,222",180148897,115148897,The Dictator,2012,Comedy
19,2017,The Shape of Water,19500000,"$63,859,435",195790794,176290794,The Shape of Water,2017,Drama
28,2013,RED 2,84000000,"$53,262,560",141507355,57507355,RED 2,2013,Crime/Mystery
59,2017,Captain Underpants: The First Epic Movie,38000000,"$73,921,000",126577874,88577874,Captain Underpants: The First Epic Movie,2017,Family/Animation
58,2017,Pitch Perfect 3,45000000,"$104,897,530",185736412,140736412,Pitch Perfect 3,2017,Comedy
39,2013,2 Guns,61000000,"$75,612,460",132493015,71493015,2 Guns,2013,Crime/Mystery
12,2011,War Horse,70000000,"$79,883,359",156815529,86815529,War Horse,2011,Drama
100,2011,Spy Kids 4-D: All the Time in the World,27000000,"$38,536,376",80681183,53681183,Spy Kids 4-D: All the Time in the World,2011,Action/Adventure
34,2012,The Pirates! Band of Misfits,55000000,"$31,051,126",136143605,81143605,The Pirates! Band of Misfits,2012,Family/Animation
91,2013,This Is the End,32000000,"$101,470,202",126539117,94539117,This Is the End,2013,Comedy
67,2014,Ride Along,25000000,"$134,202,565",153733800,128733800,Ride Along,2014,Crime/Mystery
7,2012,Mirror Mirror,85000000,"$64,935,167",173613482,88613482,Mirror Mirror,2012,Dramedy
81,2017,The Foreigner,35000000,"$34,393,507",140783360,105783360,The Foreigner,2017,Action/Thriller
51,2015,Shaun the Sheep Movie,25000000,"$19,375,982",101925161,76925161,Shaun the Sheep Movie,2015,Family/Animation
88,2012,Magic Mike,7000000,"$113,721,571",170549753,163549753,Magic Mike,2012,Dramedy
33,2015,The Hateful Eight,62000000,"$54,117,416",147864886,85864886,The Hateful Eight,2015,Crime/Mystery
9,2013,Olympus Has Fallen,70000000,"$98,927,592",172878928,102878928,Olympus Has Fallen,2013,Action/Thriller
85,2016,Jack Reacher: Never Go Back,60000000,"$58,697,076",159946489,99946489,Jack Reacher: Never Go Back,2016,Action/Thriller
36,2015,Trainwreck,35000000,"$110,212,700",141123897,106123897,Trainwreck,2015,Dramedy
12,2017,Alien: Covenant,97000000,"$74,262,031",238521247,141521247,Alien: Covenant,2017,Horror
59,2012,Paranormal Activity 4,5000000,"$53,900,335",142817992,137817992,Paranormal Activity 4,2012,Horror
11,2011,Jack and Jill,79000000,"$74,158,157",150519217,71519217,Jack and Jill,2011,Comedy
63,2010,RED,60000000,"$90,380,162",196439693,136439693,RED,2010,Crime/Mystery
70,2013,Warm Bodies,30000000,"$66,380,662",115121608,85121608,Warm Bodies,2013,Comedy
42,2015,The Big Short,28000000,"$70,259,870",133162752,105162752,The Big Short,2015,Dramedy
9,2017,The Post,50000000,"$81,903,458",179748880,129748880,The Post,2017,Biography/Historical
69,2012,Looper,30000000,"$66,486,205",170466405,140466405,Looper,2012,Crime/Mystery
100,2012,The Impossible,40000000,"$19,019,882",169590606,129590606,The Impossible,2012,Drama
5,2011,Tower Heist,85000000,"$78,046,570",150422946,65422946,Tower Heist,2011,Crime/Mystery
95,2017,The Dark Tower,60000000,"$50,701,325",113461527,53461527,The Dark Tower,2017,Action/Adventure
89,2014,Annie,65000000,"$85,911,262",139829625,74829625,Annie,2014,Family/Animation
84,2011,No Strings Attached,25000000,"$70,662,220",149228078,124228078,No Strings Attached,2011,Comedy
44,2014,"Alexander and the Terrible, Horrible, No Good, Very Bad Day",28000000,"$66,954,149",101379287,73379287,"Alexander and the Terrible, Horrible, No Good, Very Bad Day",2014,Family/Animation
21,2011,Unknown,40000000,"$63,686,397",136123083,96123083,Unknown,2011,Action/Thriller
9,2013,Mama,15000000,"$71,628,180",148095566,133095566,Mama,2013,Horror
8,2011,"Crazy, Stupid, Love.",50000000,"$84,351,197",147142328,97142328,"Crazy, Stupid, Love.",2011,Dramedy
49,2018,The First Purge,13000000,"$69,488,745",136617305,123617305,The First Purge,2018,Horror
31,2011,New Year's Eve,26000000,"$54,544,638",146850273,120850273,New Year's Eve,2011,Comedy
55,2011,Friends with Benefits,35000000,"$55,802,754",146595891,111595891,Friends with Benefits,2011,Comedy
14,2011,We Bought a Zoo,50000000,"$75,624,550",118729073,68729073,We Bought a Zoo,2011,Family/Animation
89,2011,Season of the Witch,40000000,"$24,827,228",91126600,51126600,Season of the Witch,2011,Action/Adventure
73,2011,Ghost Rider: Spirit of Vengeance,57000000,"$51,774,002",149217355,92217355,Ghost Rider: Spirit of Vengeance,2011,Action/Thriller
98,2010,Jackass 3D,20000000,"$117,229,692",171685793,151685793,Jackass 3D,2010,Comedy
100,2019,Glass,20000000,"$111,035,005",245303505,225303505,Glass,2019,Drama
96,2015,The Last Witch Hunter,80000000,"$27,367,660",130818912,50818912,The Last Witch Hunter,2015,Action/Adventure
96,2011,Source Code,32000000,"$54,712,227",140428499,108428499,Source Code,2011,Drama
10,2016,The Huntsman: Winter's War,115000000,"$48,003,015",165149302,50149302,The Huntsman: Winter's War,2016,Action/Adventure
74,2010,The Other Guys,100000000,"$119,219,978",170936470,70936470,The Other Guys,2010,Crime/Mystery
16,2018,The House with a Clock in Its Walls,40000000,"$68,549,695",126331750,86331750,The House with a Clock in Its Walls,2018,Comedy
69,2014,Let's Be Cops,17000000,"$82,390,774",136890774,119890774,Let's Be Cops,2014,Comedy
9,2010,Step Up 3D,30000000,"$42,400,223",165889117,135889117,Step Up 3D,2010,Drama
71,2011,Contagion,60000000,"$75,658,097",137551594,77551594,Contagion,2011,Action/Thriller
90,2014,Blended,45000000,"$46,290,741",127990741,82990741,Blended,2014,Comedy
52,2018,Red Sparrow,69000000,"$46,874,505",145951861,76951861,Red Sparrow,2018,Action/Thriller
77,2011,The Three Musketeers,90000000,"$20,377,913",139877913,49877913,The Three Musketeers,2011,Action/Adventure
74,2012,Step Up Revolution,33000000,"$35,074,677",165552290,132552290,Step Up Revolution,2012,Drama
54,2014,Sex Tape,40000000,"$38,543,473",126069509,86069509,Sex Tape,2014,Comedy
23,2012,Flight,31000000,"$93,772,375",160558438,129558438,Flight,2012,Drama
35,2014,The Theory of Everything,15000000,"$35,893,537",123327692,108327692,The Theory of Everything,2014,Biography/Historical
58,2017,Happy Death Day,5000000,"$55,683,845",125010260,120010260,Happy Death Day,2017,Horror
14,2011,Arthur Christmas,85000000,"$46,462,469",149717124,64717124,Arthur Christmas,2011,Family/Animation
98,2015,Fantastic Four,120000000,"$56,117,548",167849187,47849187,Fantastic Four,2015,Action/Adventure
98,2012,This Means War,65000000,"$54,760,791",156974557,91974557,This Means War,2012,Comedy
81,2011,The Adjustment Bureau,50200000,"$62,495,645",126931325,76731325,The Adjustment Bureau,2011,Action/Thriller
92,2010,The Town,37000000,"$92,186,262",152566881,115566881,The Town,2010,Drama
99,2010,Date Night,55000000,"$98,711,404",152269033,97269033,Date Night,2010,Comedy
23,2010,Tooth Fairy,48000000,"$60,022,256",112610386,64610386,Tooth Fairy,2010,Family/Animation
93,2010,Nanny McPhee Returns,35000000,"$29,197,642",97799865,62799865,Nanny McPhee Returns,2010,Family/Animation
97,2014,Jack Ryan: Shadow Recruit,60000000,"$50,577,412",131377412,71377412,Jack Ryan: Shadow Recruit,2014,Action/Thriller
91,2016,Underworld: Blood Wars,35000000,"$30,353,973",81209222,46209222,Underworld: Blood Wars,2016,Action/Adventure
79,2010,Saw 3D: The Final Chapter,17000000,"$45,710,178",133735284,116735284,Saw 3D: The Final Chapter,2010,Horror
95,2016,Ride Along 2,40000000,"$90,862,685",124827316,84827316,Ride Along 2,2016,Crime/Mystery
49,2011,Final Destination 5,40000000,"$42,587,643",155011165,115011165,Final Destination 5,2011,Horror
19,2010,Unstoppable,95000000,"$81,562,942",165720921,70720921,Unstoppable,2010,Action/Thriller
20,2018,Instant Family,48000000,"$67,363,237",119736188,71736188,Instant Family,2018,Dramedy
13,2010,Diary of a Wimpy Kid,15000000,"$64,003,625",76954311,61954311,Diary of a Wimpy Kid,2010,Family/Animation
66,2015,Magic Mike XXL,14500000,"$66,013,057",123660597,109160597,Magic Mike XXL,2015,Dramedy
37,2013,Saving Mr. Banks,35000000,"$83,299,761",114962525,79962525,Saving Mr. Banks,2013,Dramedy
17,2016,The BFG,140000000,"$55,483,770",199646680,59646680,The BFG,2016,Family/Animation
18,2012,The Woman in Black,15000000,"$54,333,290",128955898,113955898,The Woman in Black,2012,Horror
55,2011,The Best Exotic Marigold Hotel,10000000,"$46,383,639",134639780,124639780,The Best Exotic Marigold Hotel,2011,Dramedy
86,2017,Baywatch,60000000,"$58,060,186",175863783,115863783,Baywatch,2017,Crime/Mystery
34,2011,The Artist,16000000,"$44,667,095",128256712,112256712,The Artist,2011,Dramedy
47,2016,Deepwater Horizon,156000000,"$61,433,527",122603824,-33396176,Deepwater Horizon,2016,Biography/Historical
5,2017,Daddy's Home Two,70000000,"$104,029,443",175807183,105807183,Daddy's Home Two,2017,Comedy
51,2015,Insidious: Chapter 3,10000000,"$52,218,558",120453155,110453155,Insidious: Chapter 3,2015,Horror
94,2018,Game Night,37000000,"$69,179,066",117378084,80378084,Game Night,2018,Crime/Mystery
86,2015,Bajrangi Bhaijaan,13000000,"$8,178,001",121778347,108778347,Bajrangi Bhaijaan,2015,Dramedy
47,2016,Allied,106000000,"$40,098,064",119266661,13266661,Allied,2016,Drama
48,2013,Prisoners,46000000,"$61,002,302",113402302,67402302,Prisoners,2013,Crime/Mystery
42,2016,The Purge: Election Year,10000000,"$79,042,440",118514727,108514727,The Purge: Election Year,2016,Horror
6,2018,First Man,60000000,"$44,936,545",105203825,45203825,First Man,2018,Biography/Historical
66,2012,Zero Dark Thirty,52500000,"$95,720,716",134612435,82112435,Zero Dark Thirty,2012,Drama
46,2013,Last Vegas,28000000,"$63,914,167",112914167,84914167,Last Vegas,2013,Dramedy
60,2015,Paul Blart: Mall Cop 2,38000000,"$71,091,594",107650646,69650646,Paul Blart: Mall Cop 2,2015,Crime/Mystery
77,2010,Dear John,25000000,"$80,014,842",142033509,117033509,Dear John,2010,Drama
93,2011,Dolphin Tale,37000000,"$72,286,779",96068724,59068724,Dolphin Tale,2011,Family/Animation
90,2017,Valerian and the City of a Thousand Planets,180000000,"$40,479,370",215098356,35098356,Valerian and the City of a Thousand Planets,2017,Action/Adventure
54,2016,The Shallows,13000000,"$55,121,623",118763442,105763442,The Shallows,2016,Horror
97,2015,Get Hard,40000000,"$90,411,453",106511453,66511453,Get Hard,2015,Comedy
94,2016,Mechanic: Resurrection,40000000,"$21,218,403",109738840,69738840,Mechanic: Resurrection,2016,Action/Thriller
4,2013,Gangster Squad,60000000,"$46,000,903",104100903,44100903,Gangster Squad,2013,Crime/Mystery
54,2016,10 Cloverfield Lane,5000000,"$72,082,999",108286422,103286422,10 Cloverfield Lane,2016,Horror
63,2018,Goosebumps 2: Haunted Halloween,35000000,"$46,697,321",93291478,58291478,Goosebumps 2: Haunted Halloween,2018,Family/Animation
44,2010,The Sorcerer's Apprentice,160000000,"$63,150,991",217986320,57986320,The Sorcerer's Apprentice,2010,Family/Animation
55,2015,The Man from U.N.C.L.E.,75000000,"$45,445,109",104949584,29949584,The Man from U.N.C.L.E.,2015,Action/Adventure
31,2014,Horrible Bosses 2,40000000,"$54,445,357",105945357,65945357,Horrible Bosses 2,2014,Comedy
94,2017,Atomic Blonde,30000000,"$51,573,925",98345423,68345423,Atomic Blonde,2017,Action/Thriller
16,2018,Night School,29000000,"$77,339,130",103008792,74008792,Night School,2018,Comedy
57,2015,Sisters,30000000,"$87,044,645",106030660,76030660,Sisters,2015,Comedy
80,2011,Diary of a Wimpy Kid: Rodrick Rules,18000000,"$52,698,535",73695194,55695194,Diary of a Wimpy Kid: Rodrick Rules,2011,Family/Animation
75,2012,Hope Springs,30000000,"$63,536,011",133085295,103085295,Hope Springs,2012,Dramedy
62,2016,Why Him?,38000000,"$60,323,786",117425156,79425156,Why Him?,2016,Comedy
32,2010,The A-Team,110000000,"$77,222,099",177241171,67241171,The A-Team,2010,Action/Thriller
16,2013,Free Birds,55000000,"$55,750,480",110387072,55387072,Free Birds,2013,Family/Animation
63,2012,Cloud Atlas,102000000,"$27,108,272",130673154,28673154,Cloud Atlas,2012,Drama
24,2010,Wall Street: Money Never Sleeps,70000000,"$52,474,616",137431619,67431619,Wall Street: Money Never Sleeps,2010,Drama
37,2013,Escape Plan,70000000,"$25,135,965",103735965,33735965,Escape Plan,2013,Crime/Mystery
97,2014,Pompeii,80000000,"$23,169,033",108469033,28469033,Pompeii,2014,Action/Adventure
63,2011,Water for Elephants,38000000,"$58,709,717",116809717,78809717,Water for Elephants,2011,Drama
62,2018,The Commuter,40000000,"$36,343,858",101985431,61985431,The Commuter,2018,Action/Thriller
71,2014,The Purge: Anarchy,9000000,"$71,562,550",111534881,102534881,The Purge: Anarchy,2014,Horror
12,2012,The Devil Inside,1000000,"$53,262,945",101759490,100759490,The Devil Inside,2012,Horror
56,2016,Neighbors 2: Sorority Rising,35000000,"$55,340,730",108757621,73757621,Neighbors 2: Sorority Rising,2016,Comedy
24,2018,A Simple Favor,20000000,"$53,548,586",97628717,77628717,A Simple Favor,2018,Dramedy
63,2010,Insidious,1500000,"$54,009,150",99870886,98370886,Insidious,2010,Horror
11,2015,Chappie,49000000,"$31,569,268",105002056,56002056,Chappie,2015,Crime/Mystery
39,2018,The Favourite,15000000,"$34,366,783",94113929,79113929,The Favourite,2018,Biography/Historical
60,2014,Ouija,5000000,"$50,856,010",103300632,98300632,Ouija,2014,Horror
60,2018,Blockers,21000000,"$60,311,495",94045328,73045328,Blockers,2018,Comedy
73,2010,The Bounty Hunter,45000000,"$67,061,228",135808837,90808837,The Bounty Hunter,2010,Comedy
55,2012,Chronicle,12000000,"$64,575,175",123681790,111681790,Chronicle,2012,Drama
90,2013,Blue Jasmine,18000000,"$33,404,871",102912961,84912961,Blue Jasmine,2013,Drama
17,2012,Diary of a Wimpy Kid: Dog Days,22000000,"$49,008,662",77229695,55229695,Diary of a Wimpy Kid: Dog Days,2012,Family/Animation
56,2015,The Visit,5000000,"$65,206,105",98677816,93677816,The Visit,2015,Horror
99,2010,Skyline,10000000,"$21,416,355",68264973,58264973,Skyline,2010,Action/Thriller
62,2013,Instructions Not Included,5000000,"$44,467,206",100486616,95486616,Instructions Not Included,2013,Dramedy
48,2016,Risen,20000000,"$36,880,033",46255763,26255763,Risen,2016,Action/Adventure
65,2013,Philomena,12000000,"$37,709,979",98963392,86963392,Philomena,2013,Dramedy
62,2016,Dirty Grandpa,11500000,"$35,593,113",105078449,93578449,Dirty Grandpa,2016,Comedy
90,2011,The Iron Lady,14000000,"$29,959,436",115592104,101592104,The Iron Lady,2011,Biography/Historical
28,2015,Vacation,31000000,"$58,884,188",102306500,71306500,Vacation,2015,Comedy
40,2017,Ghost in the Shell,110000000,"$40,563,557",167910690,57910690,Ghost in the Shell,2017,Drama
71,2013,Rush,38000000,"$26,947,624",98230839,60230839,Rush,2013,Biography/Historical
61,2017,Jigsaw,10000000,"$38,052,832",102445196,92445196,Jigsaw,2017,Horror
20,2017,The Lego Ninjago Movie,70000000,"$59,281,555",122737201,52737201,The Lego Ninjago Movie,2017,Family/Animation
75,2012,Pitch Perfect,17000000,"$65,001,093",116044347,99044347,Pitch Perfect,2012,Comedy
22,2013,42,31000000,"$95,020,213",97470701,66470701,42,2013,Biography/Historical
86,2014,Birdman or (The Unexpected Virtue of Ignorance),18000000,"$42,340,598",103215094,85215094,Birdman or (The Unexpected Virtue of Ignorance),2014,Dramedy
98,2016,How to Be Single,37000000,"$46,843,513",100003780,63003780,How to Be Single,2016,Dramedy
98,2016,Money Monster,27000000,"$41,012,075",93466095,66466095,Money Monster,2016,Drama
59,2017,"Three Billboards Outside Ebbing, Missouri",12000000,"$54,513,740",160191915,148191915,"Three Billboards Outside Ebbing, Missouri",2017,Drama
2,2014,Transcendence,100000000,"$23,022,309",103039258,3039258,Transcendence,2014,Drama
94,2014,The Boxtrolls,60000000,"$50,837,305",111946251,51946251,The Boxtrolls,2014,Family/Animation
68,2010,The Fighter,11000000,"$93,617,009",129262388,118262388,The Fighter,2010,Biography/Historical
15,2011,Moneyball,50000000,"$75,605,492",111300835,61300835,Moneyball,2011,Biography/Historical
79,2018,Alpha,51000000,"$35,851,379",99624873,48624873,Alpha,2018,Family/Animation
29,2011,Priest,60000000,"$29,136,626",84154026,24154026,Priest,2011,Action/Adventure
89,2012,ParaNorman,60000000,"$56,003,051",108119662,48119662,ParaNorman,2012,Family/Animation
45,2011,Sanctum,30000000,"$23,209,310",108957098,78957098,Sanctum,2011,Drama
88,2015,Joy,60000000,"$56,451,232",101134059,41134059,Joy,2015,Drama
84,2017,Darkest Hour,30000000,"$56,443,120",150807172,120807172,Darkest Hour,2017,Biography/Historical
59,2015,Black Mass,53000000,"$62,575,678",98837872,45837872,Black Mass,2015,Dramedy
58,2011,Paul,40000000,"$37,412,945",101162106,61162106,Paul,2011,Comedy
46,2014,Heaven Is for Real,12000000,"$91,386,097",100916299,88916299,Heaven Is for Real,2014,Biography/Historical
48,2011,Justin Bieber: Never Say Never,13000000,"$73,013,910",99034125,86034125,Justin Bieber: Never Say Never,2011,Biography/Historical
35,2014,The Book of Life,50000000,"$50,151,543",97651543,47651543,The Book of Life,2014,Family/Animation
45,2012,Think Like a Man,12000000,"$91,547,205",113373764,101373764,Think Like a Man,2012,Comedy
77,2016,My Big Fat Greek Wedding 2,18000000,"$59,689,605",92096558,74096558,My Big Fat Greek Wedding 2,2016,Comedy
94,2017,Power Rangers,120000000,"$85,364,450",142531552,22531552,Power Rangers,2017,Action/Adventure
50,2017,Posledniy bogatyr,8500000,$0,30700192,22200192,Posledniy bogatyr,2017,Action/Adventure
36,2017,Girls Trip,28000000,"$115,108,515",140886353,112886353,Girls Trip,2017,Dramedy
91,2018,Truth or Dare,3500000,"$41,411,015",95127344,91627344,Truth or Dare,2018,Horror
41,2013,Safe Haven,28000000,"$71,399,120",94050951,66050951,Safe Haven,2013,Drama
93,2013,Walking with Dinosaurs 3D,80000000,"$36,076,121",123368842,43368842,Walking with Dinosaurs 3D,2013,Family/Animation
3,2014,Tammy,20000000,"$84,525,432",96407655,76407655,Tammy,2014,Comedy
62,2011,Green Lantern,200000000,"$116,601,172",219535492,19535492,Green Lantern,2011,Action/Adventure
13,2014,The Hundred-Foot Journey,22000000,"$54,235,441",94270488,72270488,The Hundred-Foot Journey,2014,Dramedy
39,2017,The Star,20000000,"$40,847,995",62758010,42758010,The Star,2017,Family/Animation
19,2012,Underworld Awakening,70000000,"$62,321,039",160379930,90379930,Underworld Awakening,2012,Horror
18,2012,The Campaign,95000000,"$86,907,746",104907746,9907746,The Campaign,2012,Comedy
81,2016,Office Christmas Party,45000000,"$54,767,494",91323299,46323299,Office Christmas Party,2016,Comedy
90,2013,White House Down,150000000,"$73,103,784",205440387,55440387,White House Down,2013,Action/Thriller
61,2019,Pet Sematary,21000000,"$54,724,696",109501146,88501146,Pet Sematary,2019,Horror
58,2012,Project X,12000000,"$54,731,865",103028188,91028188,Project X,2012,Comedy
67,2013,The Purge,3000000,"$64,473,115",91266581,88266581,The Purge,2013,Horror
36,2013,Ender's Game,110000000,"$61,737,191",127983283,17983283,Ender's Game,2013,Action/Adventure
70,2014,Paranormal Activity: The Marked Ones,5000000,"$32,462,372",90904854,85904854,Paranormal Activity: The Marked Ones,2014,Horror
69,2012,Sinister,3000000,"$48,086,903",87727807,84727807,Sinister,2012,Horror
51,2017,Snatched,42000000,"$45,852,178",57852177,15852177,Snatched,2017,Action/Adventure
48,2012,Frankenweenie,39000000,"$35,287,788",81150788,42150788,Frankenweenie,2012,Family/Animation
57,2011,Hall Pass,68000000,"$45,060,734",87173475,19173475,Hall Pass,2011,Comedy
49,2010,A Nightmare on Elm Street,35000000,"$63,075,011",117729621,82729621,A Nightmare on Elm Street,2010,Horror
25,2011,The Lincoln Lawyer,40000000,"$58,009,200",87145086,47145086,The Lincoln Lawyer,2011,Drama
77,2013,Evil Dead,17000000,"$54,239,856",97778356,80778356,Evil Dead,2013,Horror
21,2018,BlacKkKlansman,15000000,"$49,275,340",93017335,78017335,BlacKkKlansman,2018,Dramedy
75,2016,Ouija: Origin of Evil,9000000,"$35,144,505",81831866,72831866,Ouija: Origin of Evil,2016,Horror
62,2011,Sucker Punch,75000000,"$36,392,502",89758389,14758389,Sucker Punch,2011,Action/Adventure
99,2018,I Feel Pretty,32000000,"$48,795,601",91553797,59553797,I Feel Pretty,2018,Comedy
48,2014,A Million Ways to Die in the West,40000000,"$42,720,965",86778557,46778557,A Million Ways to Die in the West,2014,Comedy
63,2013,The Internship,58000000,"$44,672,764",93672764,35672764,The Internship,2013,Comedy
32,2017,American Made,50000000,"$51,342,000",135569212,85569212,American Made,2017,Comedy
45,2016,War Dogs,50000000,"$43,034,523",86234503,36234503,War Dogs,2016,Dramedy
20,2014,Muppets Most Wanted,55000000,"$51,178,893",79312301,24312301,Muppets Most Wanted,2014,Comedy
85,2012,Contraband,25000000,"$66,528,000",98406855,73406855,Contraband,2012,Crime/Mystery
84,2018,Teen Titans Go! To the Movies,10000000,"$29,790,236",51620593,41620593,Teen Titans Go! To the Movies,2018,Family/Animation
65,2012,Abraham Lincoln: Vampire Hunter,67500000,"$37,519,139",137489730,69989730,Abraham Lincoln: Vampire Hunter,2012,Horror
73,2014,If I Stay,11000000,"$50,474,843",78356170,67356170,If I Stay,2014,Drama
96,2011,Abduction,35000000,"$28,087,155",86648359,51648359,Abduction,2011,Action/Thriller
43,2018,Book Club,10000000,"$68,566,296",91113683,81113683,Book Club,2018,Dramedy
87,2012,The Lucky One,25000000,"$60,457,138",96633833,71633833,The Lucky One,2012,Drama
61,2010,Hereafter,50000000,"$32,746,941",108660270,58660270,Hereafter,2010,Drama
59,2010,Marmaduke,50000000,"$33,644,788",89895930,39895930,Marmaduke,2010,Family/Animation
6,2014,John Wick,30000000,"$43,037,835",76235001,46235001,John Wick,2014,Action/Thriller
95,2013,About Time,12000000,"$15,323,921",89309178,77309178,About Time,2013,Dramedy
41,2014,The Judge,50000000,"$47,119,388",76119388,26119388,The Judge,2014,Drama
6,2011,The Inbetweeners Movie,5700000,"$35,955",86051320,80351320,The Inbetweeners Movie,2011,Comedy
13,2016,Collateral Beauty,36000000,"$31,016,021",85309093,49309093,Collateral Beauty,2016,Drama
64,2010,Life as We Know It,38000000,"$53,374,681",105887837,67887837,Life as We Know It,2010,Dramedy
40,2017,A Bad Moms Christmas,28000000,"$72,110,659",127710550,99710550,A Bad Moms Christmas,2017,Comedy
81,2012,The Possession,14000000,"$49,130,588",82925064,68925064,The Possession,2012,Horror
15,2010,The Last Exorcism,1800000,"$41,034,350",70165900,68365900,The Last Exorcism,2010,Horror
92,2015,Southpaw,30000000,"$52,421,953",94156456,64156456,Southpaw,2015,Drama
68,2013,The Host,50000000,"$26,623,701",64477051,14477051,The Host,2013,Action/Adventure
17,2016,The Boss,29000000,"$63,077,560",78652207,49652207,The Boss,2016,Comedy
45,2012,This Is 40,35000000,"$67,544,505",90221182,55221182,This Is 40,2012,Comedy
29,2010,Love & Other Drugs,30000000,"$32,367,005",102716321,72716321,Love & Other Drugs,2010,Dramedy
76,2011,J. Edgar,35000000,"$37,306,030",84606030,49606030,J. Edgar,2011,Dramedy
69,2014,Brick Mansions,28000000,"$20,396,829",73421224,45421224,Brick Mansions,2014,Crime/Mystery
90,2010,Legend of the Guardians: The Owls of Ga'Hoole,100000000,"$55,675,313",139716717,39716717,Legend of the Guardians: The Owls of Ga'Hoole,2010,Family/Animation
27,2013,Snowpiercer,40000000,"$4,563,029",88069880,48069880,Snowpiercer,2013,Drama
50,2011,The Eagle,25000000,"$19,490,041",38993548,13993548,The Eagle,2011,Action/Adventure
86,2012,What to Expect When You're Expecting,37500000,"$41,152,203",88473016,50973016,What to Expect When You're Expecting,2012,Dramedy
7,2015,Paranormal Activity: The Ghost Dimension,10000000,"$18,297,124",77959374,67959374,Paranormal Activity: The Ghost Dimension,2015,Horror
47,2017,The Ballerina,30000000,"$21,858,070",96892829,66892829,The Ballerina,2017,Horror
34,2015,Spotlight,20000000,"$45,055,776",92088460,72088460,Spotlight,2015,Drama
1,2011,"Big Mommas: Like Father, Like Son",32000000,"$37,915,414",82332450,50332450,"Big Mommas: Like Father, Like Son",2011,Crime/Mystery
11,2014,Son of God,22000000,"$59,700,064",70949793,48949793,Son of God,2014,Biography/Historical
36,2014,Think Like a Man Too,24000000,"$65,028,687",70027933,46027933,Think Like a Man Too,2014,Comedy
72,2011,Tinker Tailor Soldier Spy,21000000,"$24,149,393",81452811,60452811,Tinker Tailor Soldier Spy,2011,Crime/Mystery
14,2014,Unfriended,1000000,"$32,789,645",64364198,63364198,Unfriended,2014,Horror
35,2018,The Nutcracker and the Four Realms,132900000,"$54,858,851",170293899,37393899,The Nutcracker and the Four Realms,2018,Family/Animation
54,2010,Kick-Ass,28000000,"$48,071,303",97531134,69531134,Kick-Ass,2010,Comedy
73,2015,The Second Best Exotic Marigold Hotel,10000000,"$33,078,266",90384306,80384306,The Second Best Exotic Marigold Hotel,2015,Dramedy
26,2013,Snitch,15000000,"$42,930,462",57907734,42907734,Snitch,2013,Action/Thriller
1,2015,In the Heart of the Sea,100000000,"$25,020,758",89693309,-10306691,In the Heart of the Sea,2015,Biography/Historical
62,2015,Poltergeist,35000000,"$47,425,125",95713069,60713069,Poltergeist,2015,Horror
25,2014,Selma,20000000,"$52,076,908",66776576,46776576,Selma,2014,Biography/Historical
36,2011,Drive,15000000,"$35,060,689",81357930,66357930,Drive,2011,Drama
54,2010,Killers,75000000,"$47,059,963",95572749,20572749,Killers,2010,Comedy
33,2013,Pain & Gain,26000000,"$49,875,291",81275291,55275291,Pain & Gain,2013,Crime/Mystery
88,2012,Savages,45000000,"$47,323,100",82513490,37513490,Savages,2012,Drama
2,2014,The Giver,25000000,"$45,090,374",66540205,41540205,The Giver,2014,Drama
15,2010,The Last Song,20000000,"$62,950,384",92678948,72678948,The Last Song,2010,Drama
90,2018,I Can Only Imagine,7000000,"$83,482,352",85604221,78604221,I Can Only Imagine,2018,Biography/Historical
22,2010,Get Him to the Greek,40000000,"$61,153,526",91455875,51455875,Get Him to the Greek,2010,Comedy
38,2013,My Lucky Star,8000000,$0,21970000,13970000,My Lucky Star,2013,Action/Adventure
24,2010,Burlesque,55000000,"$39,440,655",90552675,35552675,Burlesque,2010,Drama
23,2015,Tomorrowland,170000000,"$93,436,322",206627518,36627518,Tomorrowland,2015,Family/Animation
28,2013,Escape from Planet Earth,40000000,"$57,012,977",74156610,34156610,Escape from Planet Earth,2013,Family/Animation
24,2014,Seventh Son,95000000,"$17,725,785",108874967,13874967,Seventh Son,2014,Action/Adventure
81,2019,The Secret Life of Pets 2,80000000,"$63,795,655",113351496,33351496,The Secret Life of Pets 2,2019,Family/Animation
61,2013,Scary Movie 5,20000000,"$32,015,787",78613981,58613981,Scary Movie 5,2013,Comedy
68,2015,Paper Towns,12000000,"$32,000,304",85450484,73450484,Paper Towns,2015,Dramedy
100,2015,Sicario,30000000,"$46,889,293",84393749,54393749,Sicario,2015,Crime/Mystery
30,2016,Manchester by the Sea,8500000,"$47,695,371",77733867,69233867,Manchester by the Sea,2016,Drama
51,2010,Dinner for Schmucks,69000000,"$73,026,337",86796502,17796502,Dinner for Schmucks,2010,Comedy
43,2014,Jersey Boys,40000000,"$47,047,013",65282732,25282732,Jersey Boys,2014,Biography/Historical
100,2011,The Rite,37000000,"$33,047,633",97143987,60143987,The Rite,2011,Horror
58,2018,A Wrinkle in Time,103000000,"$100,478,608",133401882,30401882,A Wrinkle in Time,2018,Family/Animation
14,2012,John Carter,275000000,"$73,058,679",282778100,7778100,John Carter,2012,Action/Adventure
88,2016,The Wild Life,13000000,"$8,005,586",42446455,29446455,The Wild Life,2016,Family/Animation
64,2018,The Darkest Minds,34000000,"$12,695,691",38361428,4361428,The Darkest Minds,2018,Action/Adventure
52,2010,Piranha 3D,24000000,"$25,003,155",83660160,59660160,Piranha 3D,2010,Comedy
58,2012,To Rome with Love,21500000,"$16,684,352",74326015,52826015,To Rome with Love,2012,Comedy
56,2018,Hereditary,10000000,"$44,069,456",70133905,60133905,Hereditary,2018,Horror
90,2014,God's Not Dead,1150000,"$60,755,732",63777092,62627092,God's Not Dead,2014,Drama
41,2013,The Book Thief,19000000,"$21,488,481",76086711,57086711,The Book Thief,2013,Drama
73,2016,Mike and Dave Need Wedding Dates,33000000,"$46,009,673",75898100,42898100,Mike and Dave Need Wedding Dates,2016,Comedy
8,2015,Hitman: Agent 47,35000000,"$22,467,450",82182803,47182803,Hitman: Agent 47,2015,Crime/Mystery
52,2012,Here Comes the Boom,42000000,"$45,290,318",73239258,31239258,Here Comes the Boom,2012,Comedy
13,2012,Anna Karenina,49000000,"$12,816,367",71004627,22004627,Anna Karenina,2012,Drama
91,2015,Jupiter Ascending,179000000,"$47,482,519",181982519,2982519,Jupiter Ascending,2015,Action/Adventure
68,2016,The Boy,10000000,"$35,819,556",68220952,58220952,The Boy,2016,Horror
50,2016,Miracles from Heaven,13000000,"$61,705,123",73798736,60798736,Miracles from Heaven,2016,Biography/Historical
67,2014,A Walk Among the Tombstones,28000000,"$26,017,685",62108587,34108587,A Walk Among the Tombstones,2014,Crime/Mystery
61,2018,Overboard,12000000,"$50,316,123",85369830,73369830,Overboard,2018,Comedy
66,2013,Jack the Giant Slayer,195000000,"$65,187,603",197687603,2687603,Jack the Giant Slayer,2013,Action/Adventure
73,2015,The Wedding Ringer,23000000,"$64,460,211",80171596,57171596,The Wedding Ringer,2015,Comedy
62,2014,Earth to Echo,13000000,"$38,934,842",42174545,29174545,Earth to Echo,2014,Family/Animation
8,2010,Edge of Darkness,60000000,"$43,313,890",82812456,22812456,Edge of Darkness,2010,Crime/Mystery
85,2017,The Upside,37500000,"$108,235,497",119024536,81524536,The Upside,2017,Dramedy
76,2011,The Ides of March,23000000,"$40,962,534",77735925,54735925,The Ides of March,2011,Drama
33,2012,Moonrise Kingdom,16000000,"$45,512,466",68848446,52848446,Moonrise Kingdom,2012,Dramedy
80,2010,Alpha and Omega,20000000,"$25,107,267",48958353,28958353,Alpha and Omega,2010,Family/Animation
73,2013,The Best Man Holiday,17000000,"$70,525,195",72835710,55835710,The Best Man Holiday,2013,Dramedy
18,2016,Gods of Egypt,140000000,"$31,153,464",138836756,-1163244,Gods of Egypt,2016,Action/Adventure
34,2014,Deliver Us from Evil,30000000,"$30,577,122",87956618,57956618,Deliver Us from Evil,2014,Horror
95,2010,Takers,32000000,"$57,744,720",70587268,38587268,Takers,2010,Action/Thriller
23,2016,Ben-Hur,95000000,"$26,410,477",91669648,-3330352,Ben-Hur,2016,Action/Adventure
38,2017,Rings,25000000,"$27,793,018",82917283,57917283,Rings,2017,Horror
27,2012,The Watch,55000000,"$34,353,000",67130045,12130045,The Watch,2012,Comedy
74,2015,No Escape,5000000,"$27,288,872",42844516,37844516,No Escape,2015,Action/Thriller
72,2011,The Change-Up,52000000,"$37,243,418",75997067,23997067,The Change-Up,2011,Comedy
14,2012,Madea's Witness Protection,20000000,"$65,653,242",66950887,46950887,Madea's Witness Protection,2012,Dramedy
89,2010,Letters to Juliet,30000000,"$53,032,453",82148538,52148538,Letters to Juliet,2010,Dramedy
37,2012,The Five-Year Engagement,30000000,"$28,700,285",61623819,31623819,The Five-Year Engagement,2012,Comedy
68,2013,Thunder and the House of Magic,34000000,"$4,091",62582520,28582520,Thunder and the House of Magic,2013,Family/Animation
9,2016,Boo! A Madea Halloween,20000000,"$73,206,343",73206343,53206343,Boo! A Madea Halloween,2016,Dramedy
66,2015,War Room,3000000,"$67,790,117",73975239,70975239,War Room,2015,Drama
49,2010,Vampires Suck,20000000,"$36,661,504",81424988,61424988,Vampires Suck,2010,Comedy
14,2011,Hanna,30000000,"$40,259,119",65343694,35343694,Hanna,2011,Action/Thriller
14,2013,The Call,12800000,"$51,872,378",69821476,57021476,The Call,2013,Horror
29,2012,Rock of Ages,70000000,"$38,518,613",61031932,-8968068,Rock of Ages,2012,Dramedy
34,2015,The Transporter Refueled,22000000,"$16,029,670",69698495,47698495,The Transporter Refueled,2015,Crime/Mystery
54,2018,Sherlock Gnomes,59000000,"$43,242,871",87527651,28527651,Sherlock Gnomes,2018,Family/Animation
58,2013,The Counselor,25000000,"$16,973,715",71009334,46009334,The Counselor,2013,Drama
71,2012,That's My Boy,57500000,"$36,931,089",58085235,585235,That's My Boy,2012,Comedy
29,2012,End of Watch,15000000,"$41,003,371",57586606,42586606,End of Watch,2012,Crime/Mystery
8,2015,The Age of Adaline,30000000,"$42,629,776",68984536,38984536,The Age of Adaline,2015,Drama
18,2010,Machete,12500000,"$26,593,646",46370970,33870970,Machete,2010,Action/Thriller
55,2011,Scream 4,40000000,"$38,180,928",95989590,55989590,Scream 4,2011,Horror
78,2019,Happy Death Day 2U,9000000,"$28,051,045",64179495,55179495,Happy Death Day 2U,2019,Horror
100,2016,Sultan,11000000,"$5,599,781",72989781,61989781,Sultan,2016,Drama
17,2010,Cats & Dogs: The Revenge of Kitty Galore,85000000,"$43,585,753",113026383,28026383,Cats & Dogs: The Revenge of Kitty Galore,2010,Family/Animation
67,2010,Easy A,8000000,"$58,401,464",76200721,68200721,Easy A,2010,Dramedy
90,2012,Quartet,11000000,"$18,388,357",56178935,45178935,Quartet,2012,Dramedy
71,2010,Devil,10000000,"$33,679,655",63354114,53354114,Devil,2010,Horror
21,2013,Delivery Man,22000000,"$30,659,817",70536870,48536870,Delivery Man,2013,Dramedy
26,2013,Carrie,30000000,"$35,266,619",82409520,52409520,Carrie,2013,Horror
61,2015,The Longest Ride,34000000,"$37,446,117",63802928,29802928,The Longest Ride,2015,Drama
19,2015,The Little Prince,77500000,"$1,311,213",102028919,24528919,The Little Prince,2015,Family/Animation
43,2016,Nerve,20000000,"$38,583,626",70652284,50652284,Nerve,2016,Crime/Mystery
3,2018,Den of Thieves,30000000,"$44,947,622",80131391,50131391,Den of Thieves,2018,Crime/Mystery
42,2011,The Mechanic,42500000,"$29,121,498",76347393,33847393,The Mechanic,2011,Action/Thriller
77,2013,Grudge Match,40000000,"$29,807,260",69807260,29807260,Grudge Match,2013,Dramedy
25,2011,The Dilemma,70000000,"$48,475,290",70546865,546865,The Dilemma,2011,Dramedy
91,2013,Begin Again,8000000,"$16,170,632",68838736,60838736,Begin Again,2013,Dramedy
79,2015,Brooklyn,11000000,"$38,322,743",62076141,51076141,Brooklyn,2015,Drama
55,2011,Red Riding Hood,42000000,"$37,662,162",91678442,49678442,Red Riding Hood,2011,Horror
60,2011,Colombiana,40000000,"$36,665,854",72295262,32295262,Colombiana,2011,Action/Thriller
28,2015,Krampus,15000000,"$42,725,475",61788393,46788393,Krampus,2015,Comedy
4,2012,The Three Stooges,30000000,"$44,338,224",54052249,24052249,The Three Stooges,2012,Family/Animation
50,2018,Tag,28000000,"$54,730,625",77026186,49026186,Tag,2018,Comedy
30,2016,13 Hours,50000000,"$52,853,219",69411370,19411370,13 Hours,2016,Biography/Historical
85,2014,Boyhood,4000000,"$25,379,975",57273049,53273049,Boyhood,2014,Drama
33,2015,The Walk,35000000,"$10,161,183",61492104,26492104,The Walk,2015,Biography/Historical
59,2018,Sicario: Day of the Soldado,35000000,"$50,065,850",75885196,40885196,Sicario: Day of the Soldado,2018,Crime/Mystery
78,2018,Mile 22,35000000,"$36,108,758",66295121,31295121,Mile 22,2018,Action/Thriller
81,2015,The Boy Next Door,4000000,"$36,006,065",53401938,49401938,The Boy Next Door,2015,Horror
91,2015,Sinister 2,10000000,"$27,740,955",54104225,44104225,Sinister 2,2015,Horror
66,2017,Life,58000000,"$30,234,022",100929666,42929666,Life,2017,Horror
88,2013,One Direction: This Is Us,10000000,"$28,873,374",68541786,58541786,One Direction: This Is Us,2013,Biography/Historical
50,2018,Widows,40000000,"$42,402,632",73866088,33866088,Widows,2018,Drama
63,2015,The Gift,5000000,"$43,787,265",58978477,53978477,The Gift,2015,Crime/Mystery
40,2017,Going in Style,24000000,"$45,018,541",78672579,54672579,Going in Style,2017,Comedy
38,2012,Lawless,26000000,"$37,397,291",54393687,28393687,Lawless,2012,Drama
36,2015,Max,20000000,"$42,656,255",43658157,23658157,Max,2015,Family/Animation
64,2016,Moonlight,1500000,"$27,854,931",65245512,63745512,Moonlight,2016,Drama
87,2012,The Master,37500000,"$16,247,159",50647416,13147416,The Master,2012,Drama
37,2016,Fences,24000000,"$57,682,904",64282881,40282881,Fences,2016,Drama
75,2010,The Back-up Plan,35000000,"$37,490,007",75281179,40281179,The Back-up Plan,2010,Comedy
32,2013,Side Effects,30000000,"$32,172,757",66742138,36742138,Side Effects,2013,Crime/Mystery
22,2016,"Hail, Caesar!",22000000,"$30,080,225",64160680,42160680,"Hail, Caesar!",2016,Dramedy
61,2014,St. Vincent,13000000,"$44,137,712",54837234,41837234,St. Vincent,2014,Dramedy
81,2015,Woman in Gold,11000000,"$33,307,793",58586407,47586407,Woman in Gold,2015,Biography/Historical
72,2011,Something Borrowed,35000000,"$39,046,489",65084116,30084116,Something Borrowed,2011,Dramedy
39,2016,The Brothers Grimsby,35000000,"$6,864,016",28720470,-6279530,The Brothers Grimsby,2016,Action/Adventure
53,2017,Lady Bird,10000000,"$48,958,273",78610769,68610769,Lady Bird,2017,Dramedy
29,2013,Homefront,22000000,"$20,158,492",51695362,29695362,Homefront,2013,Action/Thriller
64,2018,12 Strong,35000000,"$45,819,713",71118378,36118378,12 Strong,2018,Biography/Historical
65,2013,Kick-Ass 2,28000000,"$28,795,985",63129909,35129909,Kick-Ass 2,2013,Crime/Mystery
61,2012,Red Tails,58000000,"$49,876,377",50365498,-7634502,Red Tails,2012,Action/Adventure
73,2017,Victoria & Abdul,21000000,"$22,245,070",68271146,47271146,Victoria & Abdul,2017,Biography/Historical
33,2011,Happy Feet Two,135000000,"$64,006,466",157956466,22956466,Happy Feet Two,2011,Family/Animation
39,2011,Footloose,24000000,"$51,802,742",62989834,38989834,Footloose,2011,Dramedy
77,2019,Hellboy,50000000,"$21,903,748",40725492,-9274508,Hellboy,2019,Action/Adventure
78,2015,The Perfect Guy,18000000,"$57,027,435",60278166,42278166,The Perfect Guy,2015,Horror
64,2012,Man on a Ledge,42000000,"$18,620,000",49621440,7621440,Man on a Ledge,2012,Crime/Mystery
44,2014,No Good Deed,13200000,"$52,543,632",54323210,41123210,No Good Deed,2014,Crime/Mystery
73,2013,Dallas Buyers Club,5000000,"$27,298,285",60611845,55611845,Dallas Buyers Club,2013,Biography/Historical
24,2011,The Tree of Life,35000000,"$13,305,665",61721826,26721826,The Tree of Life,2011,Drama
25,2011,Larry Crowne,30000000,"$35,608,245",61449135,31449135,Larry Crowne,2011,Dramedy
80,2018,Slender Man,10000000,"$30,564,825",51723644,41723644,Slender Man,2018,Horror
100,2015,Point Break,100000000,"$28,782,481",126704591,26704591,Point Break,2015,Action/Thriller
78,2014,That Awkward Moment,8000000,"$26,068,955",53068955,45068955,That Awkward Moment,2014,Comedy
37,2010,Legion,26000000,"$40,168,080",67647574,41647574,Legion,2010,Horror
84,2011,One Day,15000000,"$13,843,771",59168692,44168692,One Day,2011,Drama
6,2015,The Night Before,25000000,"$43,035,725",52427346,27427346,The Night Before,2015,Comedy
22,2016,Kubo and the Two Strings,55000000,"$48,023,088",77548122,22548122,Kubo and the Two Strings,2016,Family/Animation
53,2013,Runner Runner,30000000,"$19,316,646",60512680,30512680,Runner Runner,2013,Crime/Mystery
33,2014,Wild,15000000,"$37,880,356",52460543,37460543,Wild,2014,Biography/Historical
70,2011,Extremely Loud & Incredibly Close,40000000,"$31,847,881",55247881,15247881,Extremely Loud & Incredibly Close,2011,Drama
85,2013,Beautiful Creatures,50000000,"$19,452,138",60282876,10282876,Beautiful Creatures,2013,Drama
58,2014,About Last Night,13000000,"$48,637,684",50445860,37445860,About Last Night,2014,Comedy
75,2017,How to Be a Latin Lover,10000000,"$32,149,404",62556228,52556228,How to Be a Latin Lover,2017,Dramedy
42,2014,The Legend of Hercules,70000000,"$18,848,538",58953319,-11046681,The Legend of Hercules,2014,Action/Adventure
12,2013,A Haunted House,2500000,"$40,041,683",59922558,57422558,A Haunted House,2013,Comedy
92,2011,Madea's Big Happy Family,25000000,"$53,345,287",54160818,29160818,Madea's Big Happy Family,2011,Dramedy
56,2016,The Nice Guys,50000000,"$36,261,763",59596747,9596747,The Nice Guys,2016,Crime/Mystery
18,2012,Trouble with the Curve,60000000,"$35,763,137",47818913,-12181087,Trouble with the Curve,2012,Drama
22,2016,Florence Foster Jenkins,29000000,"$27,383,770",56000339,27000339,Florence Foster Jenkins,2016,Dramedy
80,2015,Concussion,35000000,"$34,531,832",50363790,15363790,Concussion,2015,Biography/Historical
30,2015,Entourage,30000000,"$32,363,404",46438538,16438538,Entourage,2015,Comedy
80,2015,"McFarland, USA",17000000,"$44,480,275",45707924,28707924,"McFarland, USA",2015,Biography/Historical
67,2012,The Place Beyond the Pines,15000000,"$21,403,519",47011449,32011449,The Place Beyond the Pines,2012,Drama
53,2013,The Grandmaster,38600000,"$6,594,959",57987299,19387299,The Grandmaster,2013,Biography/Historical
79,2015,Hot Pursuit,35000000,"$34,580,201",45671512,10671512,Hot Pursuit,2015,Crime/Mystery
39,2011,The Roommate,16000000,"$37,300,107",52545707,36545707,The Roommate,2011,Drama
61,2014,The November Man,15000000,"$25,018,119",34820335,19820335,The November Man,2014,Action/Thriller
86,2015,Eddie the Eagle,23000000,"$15,789,389",45060480,22060480,Eddie the Eagle,2015,Dramedy
80,2015,The Gallows,100000,"$22,764,410",41656474,41556474,The Gallows,2015,Horror
100,2018,Vice,60000000,"$47,836,282",70883171,10883171,Vice,2018,Dramedy
64,2016,Zoolander 2,50000000,"$28,848,693",55348693,5348693,Zoolander 2,2016,Comedy
12,2014,Dolphin Tale 2,36000000,"$42,024,533",57824533,21824533,Dolphin Tale 2,2014,Family/Animation
93,2013,A Madea Christmas,25000000,"$52,543,354",52543354,27543354,A Madea Christmas,2013,Dramedy
74,2013,The Last Stand,30000000,"$12,050,299",48330757,18330757,The Last Stand,2013,Action/Thriller
70,2015,Run All Night,50000000,"$26,461,644",66961644,16961644,Run All Night,2015,Action/Thriller
18,2012,Chernobyl Diaries,1000000,"$18,119,640",42411721,41411721,Chernobyl Diaries,2012,Horror
70,2017,"Everything, Everything",10000000,"$34,121,140",61603136,51603136,"Everything, Everything",2017,Drama
40,2011,Headhunters,5250000,"$1,200,010",20188740,14938740,Headhunters,2011,Action/Thriller
11,2011,The Cabin in the Woods,30000000,"$42,073,277",70689968,40689968,The Cabin in the Woods,2011,Horror
22,2016,Barbershop: The Next Cut,20000000,"$54,030,051",54404202,34404202,Barbershop: The Next Cut,2016,Dramedy
67,2011,Arthur,40000000,"$33,035,397",47787943,7787943,Arthur,2011,Comedy
22,2012,Lockout,20000000,"$14,326,865",33943049,13943049,Lockout,2012,Action/Thriller
51,2010,The American,20000000,"$35,606,376",67950723,47950723,The American,2010,Drama
66,2019,Ma,5000000,"$36,049,540",44300625,39300625,Ma,2019,Horror
72,2013,Oculus,5000000,"$27,695,246",44115496,39115496,Oculus,2013,Horror
69,2016,Patriots Day,40000000,"$31,886,361",52837989,12837989,Patriots Day,2016,Crime/Mystery
18,2013,Parker,35000000,"$17,616,641",48543388,13543388,Parker,2013,Action/Thriller
88,2018,Life of the Party,30000000,"$53,059,911",65759911,35759911,Life of the Party,2018,Comedy
49,2010,The Next Three Days,30000000,"$21,148,651",67255916,37255916,The Next Three Days,2010,Crime/Mystery
83,2011,Haywire,23000000,"$18,942,396",36374700,13374700,Haywire,2011,Action/Thriller
83,2011,Soul Surfer,18000000,"$43,853,424",47158652,29158652,Soul Surfer,2011,Biography/Historical
80,2011,Dream House,50000000,"$21,302,340",41642166,-8357834,Dream House,2011,Crime/Mystery
73,2011,50/50,8000000,"$35,016,118",41334735,33334735,50/50,2011,Dramedy
4,2018,Mortal Engines,100000000,"$15,951,040",85287417,-14712583,Mortal Engines,2018,Action/Adventure
22,2013,The Family,30000000,"$36,918,811",51078541,21078541,The Family,2013,Comedy
10,2010,Hot Tub Time Machine,36000000,"$50,269,859",65967750,29967750,Hot Tub Time Machine,2010,Comedy
11,2010,The Ghost Writer,45000000,"$15,541,549",65532491,20532491,The Ghost Writer,2010,Crime/Mystery
41,2019,A Dog's Way Home,61000000,"$41,952,715",81149689,20149689,A Dog's Way Home,2019,Family/Animation
59,2012,The Guilt Trip,40000000,"$37,134,215",41294674,1294674,The Guilt Trip,2012,Dramedy
36,2010,The Crazies,19000000,"$39,123,589",56445534,37445534,The Crazies,2010,Horror
16,2010,Why Did I Get Married Too?,20000000,"$60,095,852",60831067,40831067,Why Did I Get Married Too?,2010,Dramedy
54,2013,Yeh Jawaani Hai Deewani,8300000,"$3,827,466",50827466,42527466,Yeh Jawaani Hai Deewani,2013,Dramedy
15,2013,August: Osage County,25000000,"$37,738,810",50738810,25738810,August: Osage County,2013,Dramedy
34,2014,Nightcrawler,8500000,"$32,381,218",50334418,41834418,Nightcrawler,2014,Drama
57,2018,"Love, Simon",10000000,"$40,826,341",65520633,55520633,"Love, Simon",2018,Dramedy
53,2010,Secretariat,35000000,"$59,699,513",60376247,25376247,Secretariat,2010,Biography/Historical
39,2011,Winnie the Pooh,30000000,"$26,692,846",50145607,20145607,Winnie the Pooh,2011,Family/Animation
73,2012,House at the End of the Street,6900000,"$31,611,916",44103982,37203982,House at the End of the Street,2012,Horror
83,2018,Second Act,15700000,"$39,282,227",63288854,47588854,Second Act,2018,Dramedy
27,2016,Mother's Day,25000000,"$32,492,859",52367022,27367022,Mother's Day,2016,Dramedy
34,2011,Cowboys & Aliens,163000000,"$100,368,560",176038324,13038324,Cowboys & Aliens,2011,Action/Thriller
36,2016,The Finest Hours,70000000,"$27,569,558",49252761,-20747239,The Finest Hours,2016,Biography/Historical
6,2010,127 Hours,18000000,"$18,335,230",60217171,42217171,127 Hours,2010,Biography/Historical
60,2011,30 Minutes or Less,28000000,"$37,053,924",40966716,12966716,30 Minutes or Less,2011,Crime/Mystery
82,2012,Killing Them Softly,15000000,"$14,945,541",39238443,24238443,Killing Them Softly,2012,Crime/Mystery
89,2018,Adrift,35000000,"$31,445,011",57897191,22897191,Adrift,2018,Biography/Historical
58,2011,Fright Night,30000000,"$18,298,649",40520649,10520649,Fright Night,2011,Comedy
64,2014,3 Days to Kill,28000000,"$30,697,999",38959900,10959900,3 Days to Kill,2014,Action/Thriller
94,2015,The Witch,3500000,"$25,138,705",40454520,36954520,The Witch,2015,Horror
71,2019,Rocketman,41000000,"$57,342,725",108642725,67642725,Rocketman,2019,Biography/Historical
84,2011,Monte Carlo,20000000,"$23,186,769",39686769,19686769,Monte Carlo,2011,Family/Animation
92,2014,Still Alice,5000000,"$18,656,400",41699612,36699612,Still Alice,2014,Drama
68,2010,The Spy Next Door,28000000,"$24,307,106",46752858,18752858,The Spy Next Door,2010,Family/Animation
73,2010,Morning Glory,40000000,"$31,011,732",59795070,19795070,Morning Glory,2010,Dramedy
51,2010,Remember Me,16000000,"$19,068,240",56506120,40506120,Remember Me,2010,Drama
33,2015,The Duff,8500000,"$34,030,343",43528634,35028634,The Duff,2015,Comedy
91,2017,All Eyez on Me,45000000,"$44,922,302",54876855,9876855,All Eyez on Me,2017,Biography/Historical
84,2014,"As Above, So Below",5000000,"$21,222,315",41824066,36824066,"As Above, So Below",2014,Horror
23,2018,The 15:17 to Paris,30000000,"$36,276,286",56096200,26096200,The 15:17 to Paris,2018,Biography/Historical
15,2016,Battle for Incheon: Operation Chromite,12700000,"$1,022,720",49196532,36496532,Battle for Incheon: Operation Chromite,2016,Biography/Historical
62,2017,Downsizing,68000000,"$24,449,754",54462971,-13537029,Downsizing,2017,Drama
99,2010,Cop Out,37000000,"$44,875,481",55909910,18909910,Cop Out,2010,Crime/Mystery
78,2012,Safe,33000000,"$17,142,080",41495213,8495213,Safe,2012,Action/Thriller
39,2010,The Switch,19000000,"$27,758,465",49858465,30858465,The Switch,2010,Dramedy
1,2010,How Do You Know,120000000,"$30,212,620",49628177,-70371823,How Do You Know,2010,Dramedy
64,2010,Death at a Funeral,21000000,"$42,739,347",48977233,27977233,Death at a Funeral,2010,Comedy
81,2017,The Nut Job 2: Nutty by Nature,40000000,"$28,370,522",57438389,17438389,The Nut Job 2: Nutty by Nature,2017,Family/Animation
48,2015,Self/less,26000000,"$12,279,691",33667319,7667319,Self/less,2015,Action/Thriller
36,2012,The Odd Life of Timothy Green,40000000,"$51,853,450",55249159,15249159,The Odd Life of Timothy Green,2012,Family/Animation
51,2012,Amour,9700000,"$6,738,954",36787044,27087044,Amour,2012,Drama
13,2013,The Lone Ranger,275000000,"$89,302,115",260002115,-14997885,The Lone Ranger,2013,Action/Adventure
64,2017,The Big Sick,5000000,"$42,872,467",53972860,48972860,The Big Sick,2017,Dramedy
21,2018,Peppermint,25000000,"$35,418,723",51800758,26800758,Peppermint,2018,Crime/Mystery
87,2013,The Big Wedding,32500000,"$21,819,348",48425971,15925971,The Big Wedding,2013,Dramedy
83,2017,"I, Tonya",11000000,"$30,014,534",53797409,42797409,"I, Tonya",2017,Dramedy
79,2012,The Man with the Iron Fists,15000000,"$15,634,090",22018988,7018988,The Man with the Iron Fists,2012,Action/Thriller
36,2017,Molly's Game,30000000,"$28,780,744",53296424,23296424,Molly's Game,2017,Dramedy
37,2018,The Possession of Hannah Grace,6000000,"$14,836,174",42785387,36785387,The Possession of Hannah Grace,2018,Horror
80,2013,Her,23000000,"$25,568,251",48163815,25163815,Her,2013,Drama
31,2017,Boo 2! A Madea Halloween,20000000,"$47,319,572",47879572,27879572,Boo 2! A Madea Halloween,2017,Dramedy
94,2019,Wonder Park,100000000,"$45,216,793",115149422,15149422,Wonder Park,2019,Family/Animation
5,2012,Silent Hill: Revelation,20000000,"$17,530,219",55975672,35975672,Silent Hill: Revelation,2012,Horror
76,2013,The World's End,20000000,"$26,004,851",47508505,27508505,The World's End,2013,Comedy
32,2011,The Sitter,25000000,"$30,542,576",38749404,13749404,The Sitter,2011,Comedy
60,2015,Carol,11800000,"$12,711,491",42843521,31043521,Carol,2015,Drama
93,2011,Jumping the Broom,7000000,"$37,295,394",38158601,31158601,Jumping the Broom,2011,Dramedy
50,2014,When the Game Stands Tall,15000000,"$30,127,963",30138912,15138912,When the Game Stands Tall,2014,Family/Animation
12,2013,47 Ronin,175000000,"$38,362,475",151716815,-23283185,47 Ronin,2013,Action/Adventure
18,2012,Barfi!,4600000,"$2,804,874",36751984,32151984,Barfi!,2012,Dramedy
10,2015,Legend,25000000,"$1,872,994",42425450,17425450,Legend,2015,Dramedy
59,2012,One for the Money,42000000,"$26,414,527",36197221,-5802779,One for the Money,2012,Crime/Mystery
47,2015,The Lady in the Van,6000000,"$10,021,175",42320503,36320503,The Lady in the Van,2015,Dramedy
81,2016,Almost Christmas,17000000,"$42,065,185",42493506,25493506,Almost Christmas,2016,Dramedy
76,2015,The Lazarus Effect,5000000,"$25,801,570",38359310,33359310,The Lazarus Effect,2015,Horror
57,2014,This Is Where I Leave You,20000000,"$34,296,320",41296320,21296320,This Is Where I Leave You,2014,Dramedy
39,2016,Middle School: The Worst Years of My Life,8500000,"$20,007,149",23311293,14811293,Middle School: The Worst Years of My Life,2016,Family/Animation
9,2012,Arbitrage,12000000,"$7,919,574",35830713,23830713,Arbitrage,2012,Drama
42,2014,The Best of Me,26000000,"$26,766,213",41059418,15059418,The Best of Me,2014,Drama
19,2018,Breaking In,6000000,"$46,840,590",51411620,45411620,Breaking In,2018,Crime/Mystery
11,2013,Jobs,18000000,"$16,131,410",43402515,25402515,Jobs,2013,Biography/Historical
16,2014,Sin City: A Dame to Kill For,65000000,"$13,757,804",40650842,-24349158,Sin City: A Dame to Kill For,2014,Crime/Mystery
28,2018,Death Wish,30000000,"$34,017,028",48575965,18575965,Death Wish,2018,Crime/Mystery
7,2011,Carnage,25000000,"$2,546,747",38112154,13112154,Carnage,2011,Dramedy
87,2011,Beastly,17000000,"$27,865,571",38028230,21028230,Beastly,2011,Drama
17,2014,Million Dollar Arm,25000000,"$36,447,959",39217912,14217912,Million Dollar Arm,2014,Biography/Historical
92,2016,The Forest,10000000,"$26,594,261",40749230,30749230,The Forest,2016,Horror
14,2014,Devil's Due,7000000,"$15,821,461",36146087,29146087,Devil's Due,2014,Horror
98,2015,Love the Coopers,18000000,"$26,302,731",42227490,24227490,Love the Coopers,2015,Comedy
60,2018,Mary Queen of Scots,25000000,"$16,468,499",46734733,21734733,Mary Queen of Scots,2018,Biography/Historical
8,2012,Zambezia,20000000,$0,34454336,14454336,Zambezia,2012,Family/Animation
35,2018,Acrimony,20000000,"$43,549,096",46627836,26627836,Acrimony,2018,Drama
87,2017,Rough Night,20000000,"$22,105,643",46844357,26844357,Rough Night,2017,Comedy
21,2016,Criminal,31500000,"$14,708,696",38771262,7271262,Criminal,2016,Crime/Mystery
62,2010,She's Out of My League,20000000,"$32,010,860",48680977,28680977,She's Out of My League,2010,Comedy
43,2014,Whiplash,3300000,"$13,092,006",38969037,35669037,Whiplash,2014,Drama
1,2016,Blair Witch,10000000,"$20,777,061",38985577,28985577,Blair Witch,2016,Horror
78,2012,The Cold Light of Day,20000000,"$3,763,583",25361206,5361206,The Cold Light of Day,2012,Action/Thriller
21,2017,Logan Lucky,29000000,"$27,778,642",44264271,15264271,Logan Lucky,2017,Dramedy
58,2011,The Darkest Hour,34800000,"$21,443,494",62831715,28031715,The Darkest Hour,2011,Horror
86,2012,Good Deeds,14000000,"$35,025,791",35579177,21579177,Good Deeds,2012,Dramedy
25,2014,The Gambler,25000000,"$33,680,992",38718031,13718031,The Gambler,2014,Drama
40,2017,The Snowman,35000000,"$6,670,765",43226146,8226146,The Snowman,2017,Crime/Mystery
95,2015,Ricki and the Flash,18000000,"$26,839,498",41166033,23166033,Ricki and the Flash,2015,Dramedy
100,2012,Alex Cross,35000000,"$25,888,412",35426759,426759,Alex Cross,2012,Crime/Mystery
77,2016,Hell or High Water,12000000,"$27,007,844",37584304,25584304,Hell or High Water,2016,Crime/Mystery
91,2019,Five Feet Apart,7000000,"$45,729,221",80504421,73504421,Five Feet Apart,2019,Drama
28,2017,American Assassin,63000000,"$36,249,674",68310140,5310140,American Assassin,2017,Action/Thriller
70,2013,21 & Over,13000000,"$25,682,380",42195766,29195766,21 & Over,2013,Comedy
72,2019,The Intruder,8000000,"$35,095,904",36005871,28005871,The Intruder,2019,Horror
55,2013,Texas Chainsaw 3D,20000000,"$34,341,945",47666013,27666013,Texas Chainsaw 3D,2013,Horror
87,2016,Jackie,9000000,"$13,960,394",36588512,27588512,Jackie,2016,Biography/Historical
18,2013,Don Jon,5500000,"$24,477,704",41268579,35768579,Don Jon,2013,Dramedy
31,2010,Charlie St. Cloud,44000000,"$31,206,263",48478084,4478084,Charlie St. Cloud,2010,Drama
79,2016,Snowden,50000000,"$21,587,519",35380918,-14619082,Snowden,2016,Biography/Historical
11,2013,Broken City,35000000,"$19,701,164",34480045,-519955,Broken City,2013,Drama
21,2019,What Men Want,20000000,"$54,611,903",69911903,49911903,What Men Want,2019,Comedy
53,2011,A Very Harold & Kumar 3D Christmas,20000000,"$35,061,031",36265745,16265745,A Very Harold & Kumar 3D Christmas,2011,Comedy
17,2011,You're Next,1000000,"$18,494,006",26887177,25887177,You're Next,2011,Horror
27,2017,Diary of a Wimpy Kid: The Long Haul,22000000,"$20,738,724",35609577,13609577,Diary of a Wimpy Kid: The Long Haul,2017,Family/Animation
22,2010,Scott Pilgrim vs. the World,85000000,"$31,611,316",48056764,-36943236,Scott Pilgrim vs. the World,2010,Comedy
49,2018,SuperFly,16000000,"$20,537,137",20723581,4723581,SuperFly,2018,Action/Thriller
3,2016,Nocturnal Animals,22500000,"$10,663,357",32398681,9898681,Nocturnal Animals,2016,Drama
11,2017,Flatliners,20000000,"$16,883,115",45173738,25173738,Flatliners,2017,Horror
78,2010,You Again,20000000,"$25,702,053",32838945,12838945,You Again,2010,Family/Animation
94,2013,Inside Llewyn Davis,11000000,"$13,248,209",32943247,21943247,Inside Llewyn Davis,2013,Drama
14,2013,Kevin Hart: Let Me Explain,2500000,"$32,244,051",32327255,29827255,Kevin Hart: Let Me Explain,2013,Comedy
39,2013,Movie 43,10000000,"$8,840,453",31164747,21164747,Movie 43,2013,Comedy
87,2011,Courageous,2000000,"$34,522,221",35185884,33185884,Courageous,2011,Drama
65,2010,The Debt,20000000,"$31,177,548",46604054,26604054,The Debt,2010,Drama
35,2013,Mandela: Long Walk to Freedom,35000000,"$8,323,085",29890402,-5109598,Mandela: Long Walk to Freedom,2013,Biography/Historical
23,2019,Cold Pursuit,60000000,"$32,138,862",62599159,2599159,Cold Pursuit,2019,Crime/Mystery
75,2015,A Walk in the Woods,8000000,"$29,499,394",37119358,29119358,A Walk in the Woods,2015,Dramedy
85,2018,Uncle Drew,18000000,"$42,469,946",46527161,28527161,Uncle Drew,2018,Comedy
75,2010,From Paris with Love,52000000,"$24,077,427",53139168,1139168,From Paris with Love,2010,Action/Thriller
22,2011,My Week with Marilyn,10000000,"$14,597,405",34240572,24240572,My Week with Marilyn,2011,Biography/Historical
72,2014,Ex Machina,13000000,"$25,440,971",38358392,25358392,Ex Machina,2014,Crime/Mystery
79,2018,The Strangers: Prey at Night,5000000,"$24,431,472",29960051,24960051,The Strangers: Prey at Night,2018,Horror
27,2015,Burnt,20000000,"$13,651,946",36773510,16773510,Burnt,2015,Dramedy
43,2010,Of Gods and Men,5000000,"$3,954,651",46263525,41263525,Of Gods and Men,2010,Drama
24,2011,What's Your Number?,20000000,"$14,011,084",30163785,10163785,What's Your Number?,2011,Comedy
30,2019,Isn't It Romantic,31000000,"$48,791,187",48791187,17791187,Isn't It Romantic,2019,Comedy
9,2016,Norm of the North,18000000,"$17,062,499",30535660,12535660,Norm of the North,2016,Family/Animation
97,2013,Dark Skies,3500000,"$17,418,667",27704111,24204111,Dark Skies,2013,Horror
80,2015,Room,13000000,"$14,677,674",36262783,23262783,Room,2015,Drama
77,2017,The Bye Bye Man,7400000,"$22,395,806",31187727,23787727,The Bye Bye Man,2017,Horror
95,2018,Winchester,3500000,"$25,091,816",44378040,40878040,Winchester,2018,Biography/Historical
11,2010,Going the Distance,32000000,"$17,804,299",43603990,11603990,Going the Distance,2010,Comedy
60,2010,Ramona and Beezus,15000000,"$26,167,002",27469621,12469621,Ramona and Beezus,2010,Family/Animation
94,2011,Apollo 18,5000000,"$17,686,929",26517819,21517819,Apollo 18,2011,Horror
98,2010,Green Zone,100000000,"$35,497,337",97523020,-2476980,Green Zone,2010,Action/Thriller
90,2013,The Last Exorcism Part II,4000000,"$15,179,303",25448707,21448707,The Last Exorcism Part II,2013,Horror
23,2013,The Great Beauty,12000000,"$2,883,879",29549145,17549145,The Great Beauty,2013,Drama
52,2010,My Name Is Khan,8470000,"$4,046,336",42355526,33885526,My Name Is Khan,2010,Drama
94,2014,It Follows,2000000,"$14,674,077",23250755,21250755,It Follows,2014,Horror
76,2011,Conan the Barbarian,90000000,"$21,295,021",63356133,-26643867,Conan the Barbarian,2011,Action/Adventure
54,2013,Khumba,15000000,$0,20898221,5898221,Khumba,2013,Family/Animation
13,2012,2016: Obama's America,2500000,"$33,349,941",33349941,30849941,2016: Obama's America,2012,Biography/Historical
13,2019,Brightburn,7000000,"$16,794,432",27989498,20989498,Brightburn,2019,Horror
76,2014,A Most Wanted Man,15000000,"$17,237,855",36068890,21068890,A Most Wanted Man,2014,Drama
85,2016,When the Bough Breaks,10000000,"$29,747,603",30768449,20768449,When the Bough Breaks,2016,Horror
33,2015,Crimson Peak,55000000,"$31,090,320",74966854,19966854,Crimson Peak,2015,Horror
77,2012,The Perks of Being a Wallflower,13000000,"$17,742,948",33069303,20069303,The Perks of Being a Wallflower,2012,Drama
36,2012,Seven Psychopaths,13500000,"$15,024,049",33035736,19535736,Seven Psychopaths,2012,Comedy
60,2015,Steve Jobs,30000000,"$17,766,658",35579007,5579007,Steve Jobs,2015,Biography/Historical
33,2016,Triple 9,20000000,"$12,639,297",25943792,5943792,Triple 9,2016,Crime/Mystery
58,2018,Holmes & Watson,42000000,"$30,568,743",41926605,-73395,Holmes & Watson,2018,Comedy
6,2016,Whiskey Tango Foxtrot,35000000,"$23,083,334",25350747,-9649253,Whiskey Tango Foxtrot,2016,Dramedy
15,2012,Dredd,45000000,"$13,414,714",41467606,-3532394,Dredd,2012,Action/Thriller
67,2010,For Colored Girls,21000000,"$37,729,698",38017873,17017873,For Colored Girls,2010,Drama
79,2012,Katy Perry: Part of Me,12000000,"$25,326,071",32700439,20700439,Katy Perry: Part of Me,2012,Biography/Historical
26,2013,The Mortal Instruments: City of Bones,60000000,"$31,165,421",75965567,15965567,The Mortal Instruments: City of Bones,2013,Horror
82,2014,Endless Love,20000000,"$23,438,250",34718173,14718173,Endless Love,2014,Drama
98,2012,Mud,10000000,"$21,590,086",31556959,21556959,Mud,2012,Drama
78,2011,Your Highness,50000000,"$21,596,445",26121638,-23878362,Your Highness,2011,Comedy
40,2017,T2 Trainspotting,18000000,"$2,402,004",42091262,24091262,T2 Trainspotting,2017,Drama
87,2010,The Kids Are All Right,4000000,"$20,811,365",36275469,32275469,The Kids Are All Right,2010,Dramedy
17,2010,Furry Vengeance,35000000,"$17,630,465",39340177,4340177,Furry Vengeance,2010,Family/Animation
90,2016,The Founder,15000000,"$12,786,053",24403192,9403192,The Founder,2016,Biography/Historical
10,2012,Premium Rush,35000000,"$20,275,446",31393201,-3606799,Premium Rush,2012,Action/Thriller
86,2012,Joyful Noise,27500000,"$30,932,113",31157914,3657914,Joyful Noise,2012,Dramedy
11,2017,King Arthur: Legend of the Sword,175000000,"$39,175,066",139630336,-35369664,King Arthur: Legend of the Sword,2017,Action/Adventure
78,2011,Our Idiot Brother,5000000,"$24,814,830",25861249,20861249,Our Idiot Brother,2011,Dramedy
53,2010,Faster,24000000,"$23,240,020",35792945,11792945,Faster,2010,Crime/Mystery
27,2010,You Will Meet a Tall Dark Stranger,15000000,"$3,247,816",34247816,19247816,You Will Meet a Tall Dark Stranger,2010,Dramedy
41,2016,A Monster Calls,43000000,"$3,740,823",46414530,3414530,A Monster Calls,2016,Family/Animation
58,2011,I Don't Know How She Does It,24000000,"$9,659,074",24474463,474463,I Don't Know How She Does It,2011,Comedy
59,2011,A Separation,800000,"$7,098,492",24426169,23626169,A Separation,2011,Drama
35,2014,Get on Up,30000000,"$30,569,935",33339868,3339868,Get on Up,2014,Biography/Historical
4,2017,The Circle,18000000,"$20,497,844",40651864,22651864,The Circle,2017,Drama
75,2015,Eye in the Sky,13000000,"$18,704,596",35402802,22402802,Eye in the Sky,2015,Drama
4,2014,The Water Diviner,22500000,"$4,200,117",31054727,8554727,The Water Diviner,2014,Drama
29,2017,Fist Fight,25000000,"$32,187,017",40286416,15286416,Fist Fight,2017,Comedy
3,2012,Spring Breakers,5000000,"$14,124,286",31149251,26149251,Spring Breakers,2012,Dramedy
74,2011,Warrior,25000000,"$13,657,115",24215385,-784615,Warrior,2011,Drama
75,2019,Long Shot,40000000,"$30,202,860",43711031,3711031,Long Shot,2019,Comedy
40,2010,Leap Year,19000000,"$25,918,920",32618920,13618920,Leap Year,2010,Comedy
77,2012,Cirque du Soleil: Worlds Away,25000000,"$12,512,862",28012862,3012862,Cirque du Soleil: Worlds Away,2012,Family/Animation
7,2013,The Incredible Burt Wonderstone,32000000,"$22,537,881",27392609,-4607391,The Incredible Burt Wonderstone,2013,Comedy
94,2011,Young Adult,12000000,"$16,311,571",22750356,10750356,Young Adult,2011,Dramedy
45,2012,The Raven,26000000,"$16,008,272",30601801,4601801,The Raven,2012,Crime/Mystery
83,2013,The Way Way Back,5000000,"$21,502,690",26853810,21853810,The Way Way Back,2013,Dramedy
93,2015,Pan,150000000,"$35,088,320",151525973,1525973,Pan,2015,Family/Animation
44,2010,The Losers,25000000,"$23,591,432",29863840,4863840,The Losers,2010,Crime/Mystery
4,2013,Upside Down,50000000,"$102,118",26387039,-23612961,Upside Down,2013,Biography/Historical
20,2012,Rust and Bone,19500000,"$2,061,449",29393634,9893634,Rust and Bone,2012,Drama
89,2011,Hugo,180000000,"$73,864,507",180047784,47784,Hugo,2011,Family/Animation
98,2018,Early Man,50000000,"$8,267,544",45285890,-4714110,Early Man,2018,Family/Animation
81,2018,On the Basis of Sex,20000000,"$24,622,687",38073377,18073377,On the Basis of Sex,2018,Biography/Historical
78,2018,The Hate U Give,23000000,"$29,719,483",35067665,12067665,The Hate U Give,2018,Drama
36,2014,Draft Day,25000000,"$28,842,237",29847480,4847480,Draft Day,2014,Drama
25,2016,Hunt for the Wilderpeople,2500000,"$5,205,471",23845533,21345533,Hunt for the Wilderpeople,2016,Dramedy
40,2018,The Girl in the Spider's Web,43000000,"$14,828,555",34983342,-8016658,The Girl in the Spider's Web,2018,Crime/Mystery
43,2014,Winter's Tale,60000000,"$12,600,231",29575033,-30424967,Winter's Tale,2014,Drama
38,2011,Killer Elite,70000000,"$25,124,986",65409046,-4590954,Killer Elite,2011,Action/Thriller
43,2010,Don't Be Afraid of the Dark,25000000,"$24,046,682",39126427,14126427,Don't Be Afraid of the Dark,2010,Horror
88,2013,Enough Said,8000000,"$17,550,872",25621449,17621449,Enough Said,2013,Dramedy
16,2015,Suffragette,14000000,"$4,702,420",34044909,20044909,Suffragette,2015,Biography/Historical
90,2016,Race,5000000,"$19,115,191",23745772,18745772,Race,2016,Biography/Historical
57,2017,Home Again,15000000,"$27,020,284",37336874,22336874,Home Again,2017,Dramedy
79,2011,Hoodwinked Too! Hood vs. Evil,30000000,"$10,143,779",23353111,-6646889,Hoodwinked Too! Hood vs. Evil,2011,Family/Animation
42,2016,Silence,46500000,"$7,100,177",23726626,-22773374,Silence,2016,Biography/Historical
91,2011,Drive Angry,50000000,"$10,721,033",41042583,-8957417,Drive Angry,2011,Action/Thriller
68,2010,Sarah's Key,14500000,"$7,691,700",25480031,10980031,Sarah's Key,2010,Drama
4,2017,Gifted,7000000,"$24,801,212",36964656,29964656,Gifted,2017,Drama
90,2010,Lottery Ticket,17000000,"$24,719,879",24719879,7719879,Lottery Ticket,2010,Comedy
99,2012,Big Miracle,40000000,"$20,157,300",25268680,-14731320,Big Miracle,2012,Biography/Historical
51,2010,Arthur 3: The War of the Two Worlds,45500000,"$347,136",36180824,-9319176,Arthur 3: The War of the Two Worlds,2010,Family/Animation
59,2017,Mother!,30000000,"$17,800,004",42531076,12531076,Mother!,2017,Horror
97,2016,Kevin Hart: What Now?,10000000,"$23,591,043",23591043,13591043,Kevin Hart: What Now?,2016,Comedy
69,2017,Kidnap,21000000,"$30,718,107",34836080,13836080,Kidnap,2017,Drama
55,2013,R.I.P.D.,130000000,"$33,618,855",79076678,-50923322,R.I.P.D.,2013,Action/Adventure
38,2018,Nobody's Fool,19000000,"$31,713,110",32589493,13589493,Nobody's Fool,2018,Dramedy
85,2016,God's Not Dead 2,5000000,"$20,773,069",23551286,18551286,God's Not Dead 2,2016,Drama
86,2017,The House,40000000,"$25,584,504",31192425,-8807575,The House,2017,Comedy
6,2019,UglyDolls,45000000,"$19,894,664",24644664,-20355336,UglyDolls,2019,Family/Animation
97,2017,Wish Upon,12000000,"$14,301,505",23477345,11477345,Wish Upon,2017,Horror
81,2016,Free State of Jones,50000000,"$20,810,036",23237252,-26762748,Free State of Jones,2016,Biography/Historical
86,2019,Fighting with My Family,11000000,"$22,958,583",39049922,28049922,Fighting with My Family,2019,Dramedy
24,2011,Polisse,8900000,"$176,988",22744132,13844132,Polisse,2011,Drama
22,2018,The Hurricane Heist,40000000,"$6,115,824",30963684,-9036316,The Hurricane Heist,2018,Crime/Mystery
84,2015,Project Almanac,12000000,"$22,348,241",32909437,20909437,Project Almanac,2015,Crime/Mystery
96,2012,Sparkle,10000000,"$24,397,469",24660323,14660323,Sparkle,2012,Drama
81,2016,Monster Trucks,125000000,"$33,370,166",61642798,-63357202,Monster Trucks,2016,Action/Adventure
44,2010,Biutiful,35000000,"$5,101,237",24687524,-10312476,Biutiful,2010,Drama
91,2013,Nebraska,12000000,"$17,654,912",24761360,12761360,Nebraska,2013,Dramedy
34,2016,The Light Between Oceans,20000000,"$12,545,979",22281732,2281732,The Light Between Oceans,2016,Drama
62,2011,Melancholia,9400000,"$3,030,848",21817298,12417298,Melancholia,2011,Drama
85,2010,Just Wright,12000000,"$21,540,363",21867665,9867665,Just Wright,2010,Comedy
33,2013,The Railway Man,18000000,"$4,438,438",23910210,5910210,The Railway Man,2013,Biography/Historical
16,2011,The Rum Diary,45000000,"$13,109,815",21544732,-23455268,The Rum Diary,2011,Dramedy
95,2010,Our Family Wedding,14000000,"$20,255,281",21410546,7410546,Our Family Wedding,2010,Comedy
88,2012,Wanderlust,32500000,"$17,288,155",24159934,-8340066,Wanderlust,2012,Comedy
54,2011,The Guard,6000000,"$5,359,774",21197454,15197454,The Guard,2011,Comedy
18,2012,Beasts of the Southern Wild,1800000,"$12,795,746",23265132,21465132,Beasts of the Southern Wild,2012,Drama
14,2014,"I, Frankenstein",65000000,"$19,075,290",74575290,9575290,"I, Frankenstein",2014,Horror
23,2014,Big Eyes,10000000,"$14,482,031",27317872,17317872,Big Eyes,2014,Dramedy
99,2013,Before Midnight,3000000,"$8,110,621",23251930,20251930,Before Midnight,2013,Drama
67,2011,Red Dog,9100000,$0,20927794,11827794,Red Dog,2011,Dramedy
94,2015,Secret in Their Eyes,20000000,"$20,180,155",32608019,12608019,Secret in Their Eyes,2015,Crime/Mystery
37,2011,Margin Call,3400000,"$5,353,586",20433227,17033227,Margin Call,2011,Drama
38,2010,Let Me In,20000000,"$12,134,935",28270399,8270399,Let Me In,2010,Horror
97,2011,Shame,6500000,"$4,002,293",20412841,13912841,Shame,2011,Drama
80,2014,Top Five,12000000,"$25,317,379",26001741,14001741,Top Five,2014,Comedy
100,2017,The Disaster Artist,10000000,"$21,120,616",28717667,18717667,The Disaster Artist,2017,Dramedy
15,2016,Fifty Shades of Black,5000000,"$11,686,940",22113075,17113075,Fifty Shades of Black,2016,Comedy
30,2016,Billy Lynn's Long Halftime Walk,40000000,"$1,738,477",30230402,-9769598,Billy Lynn's Long Halftime Walk,2016,Action/Thriller
18,2014,Mr. Turner,14000000,"$3,958,546",25187026,11187026,Mr. Turner,2014,Biography/Historical
2,2010,Buried,1987650,"$1,044,143",21270290,19282640,Buried,2010,Crime/Mystery
91,2010,The Wolfman,150000000,"$62,189,884",142634358,-7365642,The Wolfman,2010,Horror
7,2017,The Zookeeper's Wife,20000000,"$17,445,186",26308749,6308749,The Zookeeper's Wife,2017,Biography/Historical
75,2017,Only the Brave,38000000,"$18,340,051",24555177,-13444823,Only the Brave,2017,Biography/Historical
71,2010,Country Strong,15000000,"$20,218,921",20601987,5601987,Country Strong,2010,Drama
39,2013,Blue Is the Warmest Color,5250000,"$2,450,504",22914479,17664479,Blue Is the Warmest Color,2013,Drama
48,2015,Mortdecai,60000000,"$7,696,134",30396134,-29603866,Mortdecai,2015,Crime/Mystery
10,2018,Bad Times at the El Royale,32000000,"$17,839,115",29204379,-2795621,Bad Times at the El Royale,2018,Crime/Mystery
80,2014,Black or White,9000000,"$21,571,189",21971021,12971021,Black or White,2014,Drama
9,2018,Robin Hood,99000000,"$30,824,628",84747441,-14252559,Robin Hood,2018,Action/Thriller
1,2012,Red Dawn,65000000,"$44,806,783",48164150,-16835850,Red Dawn,2012,Action/Thriller
72,2015,American Ultra,28000000,"$14,439,985",30295028,2295028,American Ultra,2015,Comedy
89,2014,A Haunted House 2,4000000,"$17,329,487",21206861,17206861,A Haunted House 2,2014,Comedy
24,2015,Victor Frankenstein,40000000,"$5,775,076",31124367,-8875633,Victor Frankenstein,2015,Horror
1,2012,A Thousand Words,40000000,"$18,450,127",20790486,-19209514,A Thousand Words,2012,Dramedy
78,2015,The 33,25000000,"$12,227,722",28400715,3400715,The 33,2015,Biography/Historical
42,2018,White Boy Rick,30000000,"$24,004,833",25947983,-4052017,White Boy Rick,2018,Drama
17,2016,Live by Night,65000000,"$10,378,555",21774432,-43225568,Live by Night,2016,Crime/Mystery
38,2013,Baggage Claim,8500000,"$21,569,509",22885836,14385836,Baggage Claim,2013,Comedy
32,2016,The Infiltrator,47500000,"$15,436,808",20718104,-26781896,The Infiltrator,2016,Dramedy
21,2015,Baahubali: The Beginning,40000000,"$6,738,000",26736665,-13263335,Baahubali: The Beginning,2015,Drama
3,2012,The Sapphires,9000000,"$2,450,867",20395040,11395040,The Sapphires,2012,Dramedy
95,2018,"Paul, Apostle of Christ",5000000,"$17,547,999",25529498,20529498,"Paul, Apostle of Christ",2018,Biography/Historical
3,2015,Aloha,37000000,"$21,052,030",25387091,-11612909,Aloha,2015,Dramedy
57,2014,Left Behind,16000000,"$14,019,924",20769209,4769209,Left Behind,2014,Drama
55,2019,The Kid Who Would Be King,59000000,"$16,790,790",28348446,-30651554,The Kid Who Would Be King,2019,Family/Animation
77,2011,The Thing,38000000,"$16,999,934",27573078,-10426922,The Thing,2011,Horror
32,2018,Annihilation,55000000,"$32,732,301",43070915,-11929085,Annihilation,2018,Horror
71,2013,Trance,16000000,"$2,322,593",22594052,6594052,Trance,2013,Crime/Mystery
53,2017,CHIPS,25000000,"$18,600,152",23190292,-1809708,CHIPS,2017,Crime/Mystery
50,2018,Proud Mary,30000000,"$20,868,638",21709539,-8290461,Proud Mary,2018,Crime/Mystery
56,2017,Father Figures,25000000,"$17,501,244",21038441,-3961559,Father Figures,2017,Dramedy
47,2016,Rock Dog,60000000,"$9,420,546",24148488,-35851512,Rock Dog,2016,Family/Animation
3,2019,Dark Phoenix,350000000,"$42,762,350",149762350,-200237650,Dark Phoenix,2019,Action/Adventure
57,2015,The Dressmaker,11900000,"$2,022,115",24041617,12141617,The Dressmaker,2015,Dramedy
70,2016,Keanu,15000000,"$20,591,853",20688141,5688141,Keanu,2016,Crime/Mystery
46,2013,Legends of Oz: Dorothy's Return,70000000,"$8,462,347",20107933,-49892067,Legends of Oz: Dorothy's Return,2013,Family/Animation
99,2015,Youth,13000000,"$2,703,296",24001573,11001573,Youth,2015,Dramedy
79,2010,The Nutcracker in 3D,90000000,"$195,459",20466016,-69533984,The Nutcracker in 3D,2010,Family/Animation
94,2011,Mars Needs Moms,150000000,"$21,392,758",39549758,-110450242,Mars Needs Moms,2011,Family/Animation
42,2012,Bullet to the Head,55000000,"$9,489,829",22597969,-32402031,Bullet to the Head,2012,Action/Thriller
8,2010,Another Year,8000000,"$3,205,706",20005613,12005613,Another Year,2010,Dramedy